absins	absence	3	noun	
abstrakt	abstract	1	adjective	
absulút	absolute	3	adjective	
absulútlé	absolutely	4	adverb	
ad.	ad	1	noun	
ad	add	1	verb	
adid	added	2	adjective	
adikúit	adequate	5	adjective	
administør	administer	1	verb	
administráshin	administration	4	noun	
administrátør	administrator	2	noun	
administritiv	administrative	2	adjective	
admishin	admission	2	noun	
admit	admit	0	verb	
admír	admire	2	verb	
adres	address	2	noun	
adulesint	adolescent	3	noun	
advans	advance	2	noun	
advanst	advanced	3	adjective	
advantidzh	advantage	4	noun	
adventshør	adventure	4	noun	
advís	advice	3	noun	
advíz	advise	3	verb	
advízør	adviser	3	noun	
advørtízing	advertising	3	noun	
advukát	advocate	4	verb	
advukit	advocate	4	noun	
afekt	affect	2	noun	
Afrikin-Umerikin	African-American	5	adjective	
Afrikin	African	2	adjective	
aftør	after	1	preposition	
aftørnún	afternoon	3	noun	
aftørúørd	afterward	3	adverb	
agrikultshør	agriculture	5	noun	
agrikultshørul	agricultural	5	adjective	
akéørisé	accuracy	6	noun	
akéørit	accurate	5	adjective	
akéøritlé	accurately	6	adverb	
akéøzáshin	accusation	8	noun	
akidemik	academic	3	adjective	
aknolidzh	acknowledge	5	verb	
aksent	accent	2	noun	
aksept	accept	2	verb	
akseptibul	acceptable	5	adjective	
akses	access	3	noun	
aksesibul	accessible	5	adjective	
akshin	action	4	noun	
akshúulé	actually	6	adverb	
akshúul	actual	5	adjective	
aksidint	accident	3	noun	
akt	act	1	noun	
aktiv	active	2	adjective	
aktivist	activist	1	noun	
aktivité	activity	2	noun	
aktivlé	actively	3	adverb	
aktør	actor	2	noun	
aktris	actress	3	noun	
akúizishin	acquisition	7	noun	
album	album	0	noun	
alé	alley	3	noun	
aligáshin	allegation	6	noun	
alí	ally	2	noun	
alkuhol	alcohol	2	noun	
ambasidør	ambassador	3	noun	
ambishin	ambition	3	noun	
ambishis	ambitious	4	adjective	
and	and	0	conjunction	
anéúulé	annually	5	adverb	
anéúul	annual	3	adjective	
animul	animal	1	noun	
anivørsøré	anniversary	4	noun	
ankul	ankle	2	noun	
ansestør	ancestor	2	noun	
ansør	answer	2	noun	
antisipát	anticipate	3	verb	
anulist	analyst	2	noun	
anulíz	analyze	3	verb	
aplikáshin	application	6	noun	
apul	apple	2	noun	
aset	asset	1	noun	
asf.	etc	4	adverb	and só fórth
as	ass	1	noun	
ash	ash	0	noun	
asid	acid	1	noun	
ask	ask	0	verb	
aspekt	aspect	1	noun	
asthetik	aesthetic	2	adjective	
at	at	0	preposition	
athletik	athletic	1	adjective	
athlét	athlete	2	noun	
atitúd	attitude	3	noun	
atmusfér	atmosphere	5	noun	
atribéút	attribute	4	noun	
aúr	hour	3	noun	
aúr	our	2	article	
aúrselvz	ourselves	4	pronoun	
aúrz	ours	3	pronoun	
aútdór	outdoor	4	adjective	
aútfit	outfit	2	noun	
aút	out	2	adverb	
aútkum	outcome	5	noun	
aútlit	outlet	3	noun	
aútlín	outline	4	verb	
aútør	outer	3	adjective	
aútpøt	output	3	noun	
aútsíd	outside	4	adverb	
aútsídør	outsider	4	noun	
aútstanding	outstanding	2	adjective	
avridzh	average	5	adjective	
az	as	1	adverb	
ábul	able	3	adjective	
ád	aide	3	noun	
ád	aid	2	noun	
ádzh	age	4	noun	
ádzhinsé	agency	7	noun	
ádzhint	agent	5	noun	
áléin	alien	3	noun	
ám	aim	2	noun	
ándzhul	angel	5	noun	
ánggør	anger	2	noun	
ánggré	angry	2	adjective	
ánggul	angle	3	noun	
ánshint	ancient	4	adjective	
ár	air	2	noun	
árkraft	aircraft	3	noun	
árlín	airline	4	noun	
árplán	airplane	4	noun	
árpórt	airport	3	noun	
át	eight	4	numeral	
átth	eighth	4	numeral	
Ázhin	Asian	4	adjective	
bad	bad	0	adjective	
badlé	badly	1	adverb	
bag	bag	0	noun	
bakéord	backyard	3	noun	
bak	back	1	adverb	
bakgraúnd	background	3	noun	
baktéréu	bacteria	4	noun	
balins	balance	3	noun	
balinst	balanced	4	adjective	
balit	ballot	2	noun	
band	band	0	noun	
ban	ban	0	noun	
bank	bank	0	noun	
banking	banking	0	noun	
bankør	banker	1	noun	
bankrupsé	bankruptcy	3	noun	
baskitbol	basketball	3	noun	
baskit	basket	1	noun	
bat	bat	0	noun	
bath	bath	0	noun	
bathrúm	bathroom	2	noun	
batøré	battery	3	noun	
batul	battle	2	noun	
baú	bow	2	noun	
baúndré	boundary	4	noun	
baúns	bounce	4	verb	
bábé	baby	2	noun	
bá	bay	2	noun	
bák	bake	2	verb	
báré	bury	2	verb	
báréør	barrier	4	noun	
bár	bare	2	adjective	
bár	bear	2	noun	
bárlé	barely	3	adverb	
bárul	barrel	3	noun	
básbol	baseball	4	noun	
bás	base	2	noun	
básik	basic	2	adjective	
básiklé	basically	5	adverb	
básis	basis	1	noun	
básmint	basement	3	noun	
bedrúm	bedroom	2	noun	
beg	beg	0	verb	
belé	belly	2	noun	
bel	bell	1	noun	
belt	belt	0	noun	
bend	bend	0	verb	
benifit	benefit	1	noun	
bentsh	bench	2	noun	
best	best	0	adverb	
bet	bet	0	noun	
betør	better	2	adverb	
béf	beef	2	noun	
bé	bee	2	noun	
bé	be	1	verb	
béing	being	1	noun	
bém	beam	2	noun	
bén	bean	2	noun	
béond	beyond	2	adverb	
béøró	bureau	5	noun	
bérd	beard	2	noun	
bér	beer	2	noun	
bést	beast	2	noun	
bét	beat	2	noun	
bétsh	beach	3	noun	
béúté	beauty	4	noun	
béútiful	beautiful	3	adjective	
bid	bed	1	noun	
bid	bid	0	noun	
bifór	before	3	adverb	
big	big	0	adjective	
bigin	begin	1	verb	
bigining	beginning	2	noun	
bihaf	behalf	2	preposition	
bihávéórul	behavioral	5	adjective	
bihávéør	behavior	4	noun	
biháv	behave	3	verb	
bihínd	behind	2	adverb	
bikum	become	4	verb	
bikuz	because	5	preposition	
bild	build	1	verb	
bilding	building	1	noun	
bildør	builder	2	noun	
biléf	belief	3	noun	
biléin	billion	2	numeral	
bilév	believe	4	verb	
bil	bill	1	noun	
bilong	belong	1	verb	
biló	below	3	adverb	
binéth	beneath	3	preposition	
bisíd	beside	3	preposition	
bisídz	besides	4	adverb	
bit	bit	0	adverb	
bitør	bitter	2	adjective	
bitúén	between	4	preposition	
bizé	busy	3	adjective	
biznis	business	5	noun	
biznismin	businessman	6	noun	
Bíbul	Bible	3	noun	
bí	buy	2	verb	
bí	by	1	adverb	
bíis	bias	2	noun	
bík	bike	2	noun	
bínd	bind	1	verb	
bíogrifé	biography	5	noun	
bíolidzhé	biology	6	noun	
bíør	buyer	3	noun	
bísikul	bicycle	6	noun	
bít	bite	2	noun	
bíulodzhikul	biological	7	adjective	
blak	black	1	adjective	
blast	blast	0	noun	
blád	blade	2	noun	
blám	blame	2	verb	
blánk	blank	1	adjective	
blánkit	blanket	2	noun	
blend	blend	0	verb	
bles	bless	1	verb	
blesing	blessing	1	noun	
blink	blink	0	verb	
blínd	blind	1	adjective	
blok	block	1	noun	
blond	blond	0	adjective	
bló	blow	2	noun	
bludé	bloody	3	adjective	
blud	blood	2	noun	
blú	blue	2	adjective	
bodé	body	1	noun	
bodhør	bother	2	verb	
boks	box	2	noun	
bol	ball	2	noun	
bom	bomb	1	noun	
boming	bombing	1	noun	
bond	bond	0	noun	
bor	bar	1	noun	
born	barn	1	noun	
boró	borrow	3	verb	
bos	boss	1	noun	
botul	bottle	2	noun	
botum	bottom	2	adjective	
bóifrend	boyfriend	3	noun	
bói	boy	2	noun	
bóil	boil	1	verb	
bóld	bold	1	adjective	
ból	bowl	2	noun	
bólt	bolt	1	noun	
bón	bone	2	noun	
bónis	bonus	2	noun	
bórd	board	2	noun	
bórdør	border	2	noun	
bóring	boring	1	adjective	
bórn	born	1	verb	
bóst	boast	2	verb	
bót	boat	2	noun	
bóth	both	1	adverb	
bøk	book	2	noun	
børd	bird	1	noun	
børdin	burden	2	noun	
børn	burn	1	verb	
børning	burning	1	adjective	
børst	burst	1	verb	
børthdá	birthday	3	noun	
børth	birth	1	noun	
bøsh	bush	1	noun	
brand	brand	0	noun	
brantsh	branch	2	noun	
braún	brown	2	adjective	
brák	brake	2	noun	
brák	break	2	noun	
brán	brain	2	noun	
bráv	brave	2	adjective	
brekfist	breakfast	2	noun	
brest	breast	1	noun	
breth	breath	1	noun	
brédh	breathe	4	verb	
brédhing	breathing	3	noun	
bréf	brief	2	adjective	
bréflé	briefly	3	adverb	
bréz	breeze	3	noun	
brid	bread	2	noun	
bridzh	bridge	2	noun	
brik	brick	1	noun	
briléint	brilliant	2	adjective	
bring	bring	0	verb	
British	British	0	adjective	
bríd	bride	2	noun	
brít	bright	3	adjective	
brod	broad	1	adjective	
brodkast	broadcast	2	noun	
bronz	bronze	1	noun	
brókin	broken	2	adjective	
brókør	broker	2	noun	
brudhør	brother	3	noun	
brush	brush	0	noun	
brútul	brutal	2	adjective	
bubul	bubble	2	noun	
budé	buddy	2	noun	
budzhit	budget	3	noun	
bug	bug	0	noun	
buk	buck	1	noun	
bukit	bucket	2	noun	
bulb	bulb	0	noun	
bul	bull	1	noun	
bulit	bullet	2	noun	
bulk	bulk	0	noun	
bulún	balloon	4	noun	
bunanu	banana	2	noun	
buntsh	bunch	2	noun	
bus	bus	0	noun	
but	but	0	preposition	
but	butt	1	noun	
butøn	button	2	noun	
butørflí	butterfly	3	noun	
butør	butter	2	noun	
búm	boom	2	noun	
búst	boost	2	verb	
bút	boot	2	noun	
búth	booth	2	noun	
dad	dad	0	noun	
dam	dam	0	noun	
dam	damn	1	adjective	
damidzh	damage	4	noun	
dans	dance	2	noun	
dansing	dancing	1	noun	
dansør	dancer	2	noun	
daún	down	2	adverb	
daúntaún	downtown	4	adverb	
daút	doubt	3	noun	
dábéú	debut	3	noun	
dá	day	2	noun	
dálé	daily	3	adverb	
dándzhør	danger	5	noun	
dándzhøris	dangerous	7	adjective	
dár	dare	2	verb	
dát	date	2	noun	
dátubás	database	4	noun	
dátu	data	2	noun	
dedikát	dedicate	3	verb	
dedlé	deadly	2	adjective	
dedlín	deadline	3	noun	
definishin	definition	3	noun	
definitlé	definitely	2	adverb	
defisit	deficit	1	noun	
dekád	decade	3	noun	
dek	deck	1	noun	
dekørát	decorate	4	verb	
delikit	delicate	3	adjective	
demigrafik	demographic	4	adjective	
demikratik	democratic	3	adjective	
deminstráshin	demonstration	5	noun	
deminstrát	demonstrate	3	verb	
dens	dense	1	adjective	
densité	density	1	noun	
depéøté	deputy	3	noun	
depth	depth	0	noun	
desk	desk	0	noun	
desprit	desperate	3	adjective	
despritlé	desperately	4	adverb	
destináshin	destination	4	noun	
det	debt	1	noun	
deth	death	1	noun	
devistáting	devastating	2	adjective	
devul	devil	1	noun	
dezørt	desert	2	noun	
dékrés	decrease	5	noun	
dél	deal	2	noun	
délør	dealer	3	noun	
dém	deem	2	verb	
dép	deep	2	adverb	
déplé	deeply	3	adverb	
dér	dear	2	adjective	
dér	deer	2	noun	
désint	decent	3	adjective	
détáld	detailed	4	adjective	
détál	detail	3	noun	
dhan	than	1	preposition	
dhat	that	1	adverb	
dhá	they	3	pronoun	
dhem	them	1	pronoun	
dhemselvz	themselves	3	pronoun	
dhen	then	1	adverb	
dherbí	thereby	3	adverb	
dherfór	therefore	4	adverb	
dher	their	2	article	
dher	there	2	adverb	
dhéz	these	4	determiner	
dhis	this	1	adverb	
dhó	though	5	adverb	
dhóz	those	4	determiner	
dhu	the	2	article	
dhus	thus	1	adverb	
dibát	debate	3	noun	
did	dead	2	adjective	
didzhitul	digital	4	adjective	
difend	defend	1	verb	
difendint	defendant	2	noun	
difendør	defender	2	noun	
difens	defense	2	noun	
difensiv	defensive	2	adjective	
difét	defeat	3	noun	
difikulté	difficulty	3	noun	
difikult	difficult	2	adjective	
difín	define	3	verb	
difør	differ	2	verb	
diførins	difference	5	noun	
diførint	different	3	adjective	
diførintlé	differently	4	adverb	
dig	dig	0	verb	
dignité	dignity	1	noun	
digré	degree	3	noun	
dikler	declare	4	verb	
diklín	decline	4	verb	
dikrés	decrease	5	verb	
diktát	dictate	3	verb	
dilá	delay	3	noun	
dilemu	dilemma	2	noun	
dilibritlé	deliberately	5	adverb	
dilivøré	delivery	3	noun	
dilivør	deliver	2	verb	
dilít	delight	4	noun	
dimand	demand	1	noun	
dimenshin	dimension	2	noun	
diminish	diminish	0	verb	
dimokrisé	democracy	5	noun	
diní	deny	2	verb	
diníul	denial	3	noun	
dinør	dinner	2	noun	
dipend	depend	1	verb	
dipending	depending	1	preposition	
dipendint	dependent	2	adjective	
dip	dip	0	verb	
dipikt	depict	2	verb	
diplimat	diplomat	1	noun	
diplimatik	diplomatic	2	adjective	
diplói	deploy	3	verb	
diport	depart	2	verb	
diportmint	department	3	noun	
diportshør	departure	6	noun	
dipósit	deposit	2	noun	
dipreshin	depression	3	noun	
diprest	depressed	4	adjective	
direkshin	direction	4	noun	
direkt	direct	1	adjective	
direktlé	directly	2	adverb	
direktør	director	2	noun	
dirív	derive	3	verb	
disábld	disabled	2	adjective	
disend	descend	2	verb	
dish	dish	0	noun	
disiplin	discipline	2	noun	
disizhin	decision	5	noun	
disíd	decide	4	verb	
diskaúnt	discount	3	noun	
disk	disk	0	noun	
disk	disc	1	noun	
disklóz	disclose	4	verb	
diskórs	discourse	4	noun	
diskøridzh	discourage	7	verb	
diskrimináshin	discrimination	5	noun	
diskripshin	description	5	noun	
diskríb	describe	4	verb	
diskus	discuss	2	verb	
diskushin	discussion	3	noun	
diskuvøré	discovery	4	noun	
diskuvør	discover	3	verb	
dismis	dismiss	1	verb	
disórdør	disorder	2	noun	
dispéút	dispute	3	noun	
dispít	despite	3	preposition	
displá	display	2	noun	
distinggúish	distinguish	1	verb	
distinkshin	distinction	4	noun	
distinkt	distinct	1	adjective	
distinktiv	distinctive	2	adjective	
distins	distance	3	noun	
distint	distant	1	adjective	
distørb	disturb	1	verb	
distørbing	disturbing	1	adjective	
distrakt	distract	1	verb	
distribéúshin	distribution	5	noun	
distribéút	distribute	3	verb	
distrikt	district	1	noun	
distrói	destroy	3	verb	
distrukshin	destruction	5	noun	
disubilité	disability	2	noun	
disugré	disagree	3	verb	
disupér	disappear	4	verb	
disupóintid	disappointed	4	adjective	
disupóintmint	disappointment	4	noun	
ditekt	detect	2	verb	
ditektiv	detective	3	noun	
ditørmináshin	determination	6	noun	
ditørmin	determine	3	verb	
divelup	develop	2	verb	
diveluping	developing	2	adjective	
divelupmentul	developmental	3	adjective	
divelupmint	development	3	noun	
divelupør	developer	3	noun	
divizhin	division	3	noun	
divíd	divide	2	verb	
divín	divine	2	adjective	
divís	device	4	noun	
divórs	divorce	3	noun	
divót	devote	3	verb	
divørs	diverse	2	adjective	
divørsité	diversity	2	noun	
dizastør	disaster	2	noun	
dizéz	disease	5	noun	
dizín	design	4	noun	
dizínør	designer	5	noun	
dizír	desire	4	noun	
dizolv	dissolve	3	verb	
dizørt	dessert	4	noun	
dizørv	deserve	4	verb	
díagnós	diagnose	3	verb	
díagnósis	diagnosis	2	noun	
dí	die	2	verb	
díing	dying	1	adjective	
díit	diet	2	noun	
dímind	diamond	3	noun	
dínamik	dynamic	2	adjective	
dínamiks	dynamics	2	noun	
díning	dining	1	noun	
díørí	diary	3	noun	
díubétéz	diabetes	5	noun	
díulog	dialogue	4	noun	
dog	dog	0	noun	
dokéømentøré	documentary	5	noun	
dokéømint	document	4	noun	
dok	dock	1	noun	
doktør	doctor	2	noun	
doktrin	doctrine	2	noun	
dol	doll	1	noun	
dominát	dominate	2	verb	
dominint	dominant	1	adjective	
don	dawn	2	noun	
dork	dark	1	adjective	
dorknis	darkness	3	noun	
dot	dot	0	noun	
dotør	daughter	5	noun	
dó	dough	4	noun	
dómán	domain	3	noun	
dónáshin	donation	5	noun	
dónát	donate	3	verb	
dónør	donor	2	noun	
dór	door	2	noun	
dórúá	doorway	5	noun	
dós	dose	2	noun	
døring	during	1	preposition	
dørté	dirty	2	adjective	
dørt	dirt	1	noun	
draft	draft	0	noun	
drag	drag	0	verb	
draún	drown	2	verb	
drán	drain	2	verb	
dres	dress	1	noun	
drém	dream	2	noun	
drift	drift	0	verb	
dril	drill	1	verb	
drink	drink	0	noun	
drinking	drinking	0	noun	
dríd	dried	2	adjective	
drí	dry	1	adjective	
drív	drive	2	noun	
dríving	driving	1	adjective	
drívør	driver	2	noun	
drívúá	driveway	5	noun	
dro	draw	2	verb	
droing	drawing	2	noun	
dromu	drama	2	noun	
drop	drop	0	noun	
drór	drawer	3	noun	
drug	drug	0	noun	
drumatik	dramatic	2	adjective	
drumatiklé	dramatically	5	adverb	
drum	drum	0	noun	
drunk	drunk	0	adjective	
dubré	debris	3	noun	
dubul	double	3	adjective	
duk	duck	1	noun	
dumestik	domestic	2	adjective	
dum	dumb	1	adjective	
dump	dump	0	verb	
dust	dust	0	noun	
Dutsh	Dutch	1	adjective	
duzin	dozen	2	numeral	
dú	do	1	verb	
dú	due	2	adjective	
dúté	duty	2	noun	
dzhakit	jacket	5	noun	
dzhapinéz	Japanese	7	adjective	
dzhaz	jazz	4	noun	
dzhál	jail	4	noun	
dzhendør	gender	4	noun	
dzhenéúin	genuine	6	adjective	
dzhenøráshin	generation	8	noun	
dzhenørát	generate	6	verb	
dzhenøris	generous	6	adjective	
dzhenørulé	generally	7	adverb	
dzhenørul	general	5	adverb	
dzhentlé	gently	4	adverb	
dzhentul	gentle	5	adjective	
dzhentulmin	gentleman	6	noun	
dzhestshør	gesture	7	noun	
dzhet	jet	3	noun	
dzhénéis	genius	6	noun	
dzhén	gene	5	noun	
dzhénz	jeans	5	noun	
dzhim	gym	4	noun	
dzhinetik	genetic	5	adjective	
dzhíint	giant	5	adjective	
dzhob	job	3	noun	
dzho	jaw	4	noun	
dzhor	jar	4	noun	
dzhói	joy	5	noun	
dzhóin	join	4	verb	
dzhóint	joint	4	adjective	
dzhók	joke	5	noun	
dzhøré	jury	5	noun	
dzhørmin	German	5	adjective	
dzhørné	journey	6	noun	
dzhørnul	journal	5	noun	
dzhørnulist	journalist	5	noun	
dzhørnulizm	journalism	6	noun	
dzhørør	juror	5	noun	
dzhudzh	judge	5	noun	
dzhudzhmint	judgment	6	noun	
dzhump	jump	3	noun	
dzhunggul	jungle	5	noun	
dzhust	just	3	adverb	
dzhustifí	justify	4	verb	
dzhustis	justice	5	noun	
dzhúdishul	judicial	7	adjective	
dzhúlré	jewelry	5	noun	
dzhúnéør	junior	6	adjective	
dzhúrisdikshin	jurisdiction	8	noun	
dzhús	juice	5	noun	
e-mál	e-mail	2	noun	
edishin	edition	3	noun	
edit	edit	0	verb	
editør	editor	1	noun	
edzhéøkáshin	education	9	noun	
edzhéøkáshinul	educational	10	adjective	
edzhéøkát	educate	7	verb	
edzhéøkátør	educator	7	noun	
edzh	edge	2	noun	
efekt	effect	2	noun	
efektiv	effective	3	adjective	
efektivlé	effectively	4	adverb	
efektivnis	effectiveness	5	noun	
eført	effort	2	noun	
eg	egg	1	noun	
egzakt	exact	3	adjective	
egzaktlé	exactly	4	adverb	
egzam	exam	2	noun	
egzamináshin	examination	6	noun	
egzamin	examine	3	verb	
egzampul	example	4	noun	
egzekéøtiv	executive	6	noun	
egzekéúshin	execution	8	noun	
egzibishin	exhibition	5	noun	
egzibit	exhibit	2	noun	
egzist	exist	2	verb	
egzisting	existing	2	adjective	
egzistins	existence	5	noun	
egzost	exhaust	4	verb	
egzotik	exotic	3	adjective	
ekilodzhikul	ecological	7	adjective	
ekinomik	economic	3	adjective	
ekinomiklé	economically	6	adverb	
ekinomiks	economics	3	noun	
ekonimé	economy	3	noun	
ekonimist	economist	2	noun	
ekó	echo	3	verb	
eksekéút	execute	6	verb	
ekselirát	accelerate	6	verb	
eksepshin	exception	5	noun	
eksept	except	2	preposition	
ekseptins	acceptance	6	noun	
eksesiv	excessive	4	adjective	
ekséd	exceed	4	verb	
eksilint	excellent	5	adjective	
eksit	exit	2	noun	
eksítid	excited	4	adjective	
eksíting	exciting	3	adjective	
eksítmint	excitement	5	noun	
ekskéús	excuse	6	noun	
ekskéúz	excuse	6	verb	
eksklúd	exclude	5	verb	
eksklúsiv	exclusive	5	adjective	
eksklúsivlé	exclusively	6	adverb	
eksørsíz	exercise	7	noun	
ekspand	expand	2	verb	
ekspanshin	expansion	4	noun	
ekspedishin	expedition	5	noun	
ekspektáshin	expectation	7	noun	
ekspekt	expect	3	verb	
ekspektid	expected	4	adjective	
ekspens	expense	3	noun	
ekspens	expensive	5	adjective	
ekspiréins	experience	7	noun	
ekspiréinst	experienced	8	adjective	
ekspirimentul	experimental	4	adjective	
ekspirimint	experiment	4	noun	
eksplán	explain	4	verb	
eksplináshin	explanation	7	noun	
eksplisit	explicit	3	adjective	
eksplód	explode	4	verb	
eksplóit	exploit	3	verb	
eksplóráshin	exploration	7	noun	
eksplór	explore	4	verb	
eksplózhin	explosion	6	noun	
ekspórt	export	3	noun	
ekspóz	expose	5	verb	
ekspózhør	exposure	7	noun	
ekspørtéz	expertise	6	noun	
ekspørt	expert	3	noun	
ekspres	express	3	verb	
ekspreshin	expression	4	noun	
ekstend	extend	2	verb	
ekstendid	extended	3	adjective	
ekstenshin	extension	4	noun	
ekstensiv	extensive	3	adjective	
ekstent	extent	2	noun	
ekstørnul	external	4	adjective	
ekstrém	extreme	4	adjective	
ekstrémlé	extremely	5	adverb	
ekstrórdineré	extraordinary	6	adjective	
ekstru	extra	3	adjective	
ekstshándzh	exchange	8	noun	
ekúip	equip	2	verb	
ekúipmint	equipment	3	noun	
ekúité	equity	3	noun	
ekúivilint	equivalent	4	noun	
elbó	elbow	2	noun	
eldør	elder	1	noun	
eldørlé	elderly	2	adjective	
elét	elite	2	noun	
elidzhibul	eligible	5	adjective	
elifint	elephant	4	noun	
eligint	elegant	2	adjective	
elimentøré	elementary	3	adjective	
elimint	element	2	noun	
elivátør	elevator	3	noun	
els	else	1	adverb	
elsúer	elsewhere	4	adverb	
emberist	embarrassed	6	adjective	
embrás	embrace	3	verb	
emfisis	emphasis	3	noun	
emfisíz	emphasize	5	verb	
empír	empire	2	noun	
emplóié	employee	4	noun	
emplói	employ	2	verb	
emplóimint	employment	3	noun	
emplóiør	employer	3	noun	
empté	empty	1	adjective	
enakt	enact	1	verb	
enábul	enable	3	verb	
end	end	0	noun	
endlis	endless	2	adjective	
endórs	endorse	2	verb	
endør	endure	2	verb	
endzhinér	engineer	5	noun	
endzhinéring	engineering	5	noun	
endzhin	engine	4	noun	
endzhói	enjoy	5	verb	
enébudé	anybody	4	pronoun	
ené	any	2	adverb	
enémór	anymore	4	adverb	
enéthing	anything	2	pronoun	
enéúá	anyway	5	adverb	
enéúer	anywhere	5	adverb	
enéúun	anyone	5	pronoun	
enfórs	enforce	3	verb	
enfórsmint	enforcement	4	noun	
enggádzh	engage	4	verb	
enggádzhmint	engagement	5	noun	
engshis	anxious	5	adjective	
enhans	enhance	2	verb	
enimé	enemy	2	noun	
enkaúntør	encounter	4	noun	
enkøridzh	encourage	7	verb	
enkøridzhing	encouraging	7	adjective	
enksíeté	anxiety	5	noun	
enørdzhé	energy	5	noun	
enról	enroll	2	verb	
enshør	ensure	3	verb	
enthuzéazm	enthusiasm	3	noun	
entité	entity	1	noun	
entír	entire	2	adjective	
entírlé	entirely	3	adverb	
entítul	entitle	3	verb	
entør	enter	1	verb	
entørpríz	enterprise	4	noun	
entørtánmint	entertainment	4	noun	
entrens	entrance	3	noun	
entré	entry	1	noun	
envelóp	envelope	2	noun	
envizhin	envision	3	verb	
envírnmentul	environmental	3	adjective	
envírnmint	environment	3	noun	
epidemik	epidemic	1	noun	
episód	episode	2	noun	
eréu	area	3	noun	
eró	arrow	4	noun	
erør	error	2	noun	
eru	era	1	noun	
esá	essay	3	noun	
esens	essence	3	noun	
esenshulé	essentially	6	adverb	
esenshul	essential	4	adjective	
eskáp	escape	3	noun	
espeshulé	especially	5	adverb	
establish	establish	0	verb	
establishmint	establishment	1	noun	
estát	estate	2	noun	
estimátid	estimated	2	adjective	
estimit	estimate	2	noun	
ethiks	ethics	1	noun	
ethikul	ethical	2	adjective	
ethnik	ethnic	1	adjective	
evaléúáshin	evaluation	6	noun	
evaléúát	evaluate	4	verb	
event	event	0	noun	
eventshúulé	eventually	5	adverb	
evidens	evidence	2	noun	
evidint	evident	1	adjective	
evilúshin	evolution	5	noun	
evolv	evolve	1	verb	
evør	ever	1	adverb	
evrébudé	everybody	4	pronoun	
evrédá	everyday	4	adjective	
evré	every	2	article	
evréthing	everything	2	pronoun	
evréúer	everywhere	5	adverb	
evréúun	everyone	5	pronoun	
éa	yeah	3	interjection	
édhør	either	4	adverb	
éel	yell	2	verb	
éeló	yellow	4	adjective	
ées	yes	1	interjection	
éestørdá	yesterday	4	adverb	
éet	yet	1	adverb	
égó	ego	2	noun	
égør	eager	3	adjective	
éiéld	yield	2	noun	
éiér	year	3	noun	
ékósistum	ecosystem	5	noun	
ékúázhin	equation	7	noun	
ékúolité	equality	5	noun	
ékúulé	equally	6	adverb	
ékúul	equal	4	adjective	
éord	yard	2	noun	
éór	your	3	article	
éórself	yourself	3	pronoun	
éórz	yours	4	pronoun	
Éørupéin	European	5	adjective	
ér	ear	2	noun	
ést	east	2	noun	
éstørn	eastern	3	adjective	
ét	eat	2	verb	
éting	eating	2	noun	
étsh	each	3	pronoun	
éung	young	2	adjective	
éungstør	youngster	3	noun	
éú	you	3	pronoun	
éúnéin	union	4	noun	
éúnék	unique	6	adjective	
éúnifórm	uniform	3	noun	
éúnité	unity	3	noun	
éúnit	unit	2	noun	
éúnivørs	universe	4	noun	
éúnivørsité	university	4	noun	
éúnivørsul	universal	4	adjective	
éúnít	unite	4	verb	
éúnítid	United	4	adjective	
éúsful	useful	3	adjective	
éús	use	3	noun	
éúth	youth	3	noun	
éútilité	utility	3	noun	
éútilíz	utilize	4	verb	
éúzd	used	3	adjective	
éúz	use	3	verb	
éúzhúulé	usually	7	adverb	
éúzhúul	usual	6	adjective	
éúzør	user	4	noun	
évin	even	2	adverb	
évning	evening	2	noun	
évul	evil	2	adjective	
ézé	easy	4	adverb	
éz	ease	4	noun	
ézilé	easily	4	adverb	
fabrik	fabric	1	noun	
fakt	fact	1	noun	
faktøré	factory	3	noun	
faktør	factor	2	noun	
fakulté	faculty	2	noun	
familé	family	1	noun	
fan	fan	0	noun	
fantastik	fantastic	1	adjective	
fantusé	fantasy	2	noun	
fashin	fashion	1	noun	
fasináting	fascinating	2	adjective	
fast	fast	0	adverb	
fastør	faster	1	adjective	
fat	fat	0	adjective	
faúndáshin	foundation	6	noun	
faúnd	found	2	verb	
faúndør	founder	3	noun	
fád	fade	2	verb	
fáléør	failure	5	noun	
fál	fail	2	verb	
fám	fame	2	noun	
fámis	famous	3	adjective	
fánt	faint	2	adjective	
fár	fair	2	adjective	
fár	fare	2	noun	
fárlé	fairly	3	adverb	
fás	face	3	noun	
fát	fate	2	noun	
fáth	faith	2	noun	
fátul	fatal	2	adjective	
fávør	favor	2	noun	
fávøribul	favorable	5	adjective	
fávrit	favorite	3	adjective	
fáz	phase	5	noun	
fedhør	feather	3	noun	
fedørul	federal	2	adjective	
feló	fellow	3	adjective	
feminist	feminist	0	adjective	
fens	fence	2	noun	
festivul	festival	1	noun	
fédbak	feedback	3	noun	
féd	feed	2	verb	
fé	fee	2	noun	
féld	field	2	noun	
fél	feel	2	noun	
féling	feeling	2	noun	
fémál	female	3	adjective	
fér	fear	2	noun	
férs	fierce	4	adjective	
fétshør	feature	6	noun	
féú	few	2	determiner	
féúl	fuel	2	noun	
féúnirul	funeral	4	noun	
féúør	fewer	3	determiner	
féútshør	future	6	adjective	
févør	fever	2	noun	
fifté	fifty	1	numeral	
fiftén	fifteen	2	numeral	
fifth	fifth	0	numeral	
figéør	figure	3	noun	
fiks	fix	2	verb	
fikshin	fiction	4	noun	
fikst	fixed	3	adjective	
fil	fill	1	verb	
filisofikul	philosophical	7	adjective	
film	film	0	noun	
filosifé	philosophy	6	noun	
filtør	filter	1	noun	
finggør	finger	1	noun	
finish	finish	0	noun	
finominon	phenomenon	4	noun	
fish	fish	0	noun	
fishing	fishing	0	noun	
fishørmin	fisherman	2	noun	
fiskul	fiscal	2	adjective	
fist	fist	0	noun	
fit	fit	0	adjective	
fitnis	fitness	2	noun	
fiziklé	physically	8	adverb	
fiziks	physics	5	noun	
fizikul	physical	6	adjective	
fizishin	physician	7	noun	
fíbør	fiber	2	noun	
fíl	file	2	noun	
fínans	finance	3	noun	
fínanshul	financial	4	adjective	
fínd	find	1	verb	
fínding	finding	1	noun	
fín	fine	2	adjective	
fínulé	finally	4	adverb	
fínul	final	2	adjective	
fír	fire	2	noun	
fít	fight	3	noun	
fíting	fighting	3	noun	
fítør	fighter	4	noun	
fív	five	2	numeral	
flag	flag	0	noun	
flash	flash	0	noun	
flat	flat	0	adjective	
flaúr	flour	2	noun	
flaúr	flower	3	noun	
flám	flame	2	noun	
flávør	flavor	2	noun	
fleksibilité	flexibility	3	noun	
fleksibul	flexible	4	adjective	
flesh	flesh	0	noun	
flé	flee	2	verb	
flét	fleet	2	noun	
flip	flip	0	verb	
flí	fly	1	noun	
flíing	flying	1	adjective	
flít	flight	3	noun	
fló	flow	2	noun	
flór	floor	2	noun	
flót	float	2	verb	
flud	flood	2	noun	
flúid	fluid	1	noun	
fodhør	father	3	noun	
fog	fog	0	noun	
fol	fall	2	noun	
foló	follow	3	verb	
folóing	following	3	adjective	
fols	false	2	adjective	
folt	fault	2	noun	
for	far	1	adverb	
form	farm	1	noun	
formør	farmer	2	noun	
fostør	foster	1	verb	
fók	folk	2	noun	
fókis	focus	3	noun	
fóld	fold	1	verb	
fón	phone	4	noun	
fórevør	forever	2	adverb	
fórget	forget	1	verb	
fór	for	1	preposition	
fór	four	2	numeral	
fórgiv	forgive	2	verb	
fórhed	forehead	3	noun	
fórin	foreign	3	adjective	
fórinør	foreigner	4	noun	
fórist	forest	2	noun	
fórk	fork	1	noun	
fórmat	format	1	noun	
fórmáshin	formation	5	noun	
fórméølu	formula	4	noun	
fórm	form	1	noun	
fórmør	former	2	determiner	
fórmørlé	formerly	3	adverb	
fórmul	formal	2	adjective	
fórs	force	3	noun	
fórté	forty	2	numeral	
fórth	forth	1	adverb	
fórth	fourth	2	numeral	
fórtshin	fortune	5	noun	
fórtshinitlé	fortunately	7	adverb	
fórum	forum	1	noun	
fórúørd	forward	3	adverb	
fótó	photo	4	noun	
fótugraf	photograph	6	noun	
førbid	forbid	1	verb	
førdhørmór	furthermore	5	adverb	
før	fur	1	noun	
førm	firm	1	adjective	
førmlé	firmly	2	adverb	
førnitshør	furniture	5	noun	
først	first	1	adverb	
føtbol	football	4	noun	
føt	foot	2	noun	
fradzhul	fragile	5	adjective	
fragmint	fragment	1	noun	
frakshin	fraction	4	noun	
frantshíz	franchise	5	noun	
fraún	frown	2	verb	
frám	frame	2	noun	
frámúørk	framework	4	noun	
fránklé	frankly	2	adverb	
fráz	phrase	5	noun	
frend	friend	1	noun	
frendlé	friendly	2	adjective	
frendship	friendship	1	noun	
Frentsh	French	2	adjective	
fresh	fresh	0	adjective	
freshmin	freshman	1	noun	
frédum	freedom	3	noun	
fré	free	2	adjective	
frékúinsé	frequency	6	noun	
frékúint	frequent	4	adjective	
frékúintlé	frequently	5	adverb	
frélé	freely	3	adverb	
fréz	freeze	3	verb	
Frídá	Friday	3	noun	
frod	fraud	2	noun	
frózin	frozen	2	adjective	
frum	from	1	preposition	
fruntér	frontier	3	noun	
frunt	front	1	adjective	
frustráshin	frustration	4	noun	
frustrát	frustrate	2	verb	
frút	fruit	2	noun	
fuking	fucking	1	adjective	
ful-tím	full-time	3	adjective	
fulé	fully	2	adverb	
ful	full	1	adjective	
fumiléør	familiar	3	adjective	
fund	fund	0	noun	
fundimentul	fundamental	2	adjective	
funding	funding	0	noun	
funé	funny	2	adjective	
fun	fun	0	adjective	
funkshin	function	4	noun	
funkshinul	functional	5	adjective	
fusilitát	facilitate	4	verb	
fusilité	facility	3	noun	
futég	fatigue	4	noun	
futogrifé	photography	7	noun	
futogrifør	photographer	7	noun	
fúd	food	2	noun	
fúl	fool	2	noun	
gadhør	gather	2	verb	
gadhøring	gathering	2	noun	
galiksé	galaxy	4	noun	
galøré	gallery	3	noun	
gang	gang	0	noun	
gap	gap	0	noun	
gas	gas	0	noun	
gasilén	gasoline	3	noun	
gá	gay	2	adjective	
gám	game	2	noun	
gán	gain	2	noun	
gát	gate	2	noun	
gáz	gaze	2	noun	
gerinté	guarantee	5	noun	
ges	guess	2	verb	
gest	guest	1	noun	
get	get	0	verb	
gér	gear	2	noun	
		0		
		0		
		0		
gift	gift	0	noun	
giftid	gifted	1	adjective	
gilté	guilty	2	adjective	
gilt	guilt	1	noun	
gitor	guitar	2	noun	
giv	give	1	verb	
givin	given	1	adjective	
gíd	guide	3	noun	
gídins	guidance	5	noun	
gídlín	guideline	5	noun	
gí	guy	2	noun	
glad	glad	0	adjective	
glans	glance	2	noun	
glas	glass	1	noun	
glimps	glimpse	1	noun	
glób	globe	2	noun	
glóbul	global	2	adjective	
glóré	glory	2	noun	
gluv	glove	2	noun	
God	God	0	noun	
golf	golf	0	noun	
gorbidzh	garbage	5	noun	
gord	guard	2	noun	
gordin	garden	2	noun	
gorlik	garlic	2	noun	
gó	go	1	verb	
góld	gold	1	noun	
góldin	golden	2	adjective	
gól	goal	2	noun	
góst	ghost	2	noun	
gót	goat	2	noun	
gød	good	2	adjective	
gørlfrend	girlfriend	2	noun	
gørl	girl	1	noun	
gørozh	garage	4	noun	
grab	grab	0	verb	
gradzhúáshin	graduation	7	noun	
gradzhúát	graduate	5	noun	
gradzhúilé	gradually	5	adverb	
gradzhúit	graduate	5	noun	
grandfodhør	grandfather	3	noun	
grand	grand	0	adjective	
grandmudhør	grandmother	3	noun	
grandperint	grandparent	2	noun	
grant	grant	0	noun	
grantshíld	grandchild	3	noun	
gras	grass	1	noun	
grasp	grasp	0	verb	
graúnd	ground	2	noun	
gravité	gravity	1	noun	
grád	grade	2	noun	
grá	gray	2	adjective	
grán	grain	2	noun	
gráp	grape	2	noun	
grás	grace	3	noun	
grátful	grateful	2	adjective	
grát	great	2	adjective	
grátist	greatest	3	adjective	
grátlé	greatly	3	adverb	
gráv	grave	2	noun	
gréf	grief	2	noun	
Grék	Greek	2	adjective	
grén	green	2	adjective	
grét	greet	2	verb	
grin	grin	0	noun	
grip	grip	0	noun	
gró	grow	2	verb	
gróing	growing	2	adjective	
grós	gross	2	adjective	
gróshré	grocery	4	noun	
gróth	growth	2	noun	
grúp	group	2	noun	
gun	gun	0	noun	
gut	gut	0	noun	
guvinør	governor	4	noun	
guvørmint	government	4	noun	
guvørn	govern	2	verb	
		0		
habitat	habitat	0	noun	
habit	habit	0	noun	
haf	half	1	noun	
hafúá	halfway	4	adverb	
handful	handful	0	noun	
hand	hand	0	noun	
handul	handle	2	noun	
hang	hang	0	verb	
hansum	handsome	3	adjective	
hapé	happy	2	adjective	
hapénis	happiness	4	noun	
hapilé	happily	2	adverb	
hapin	happen	2	verb	
hat	hat	0	noun	
haúevør	however	3	adverb	
haú	how	2	adverb	
haús	house	3	noun	
haúshóld	household	4	noun	
haúzing	housing	3	noun	
hav	have	1	verb	
hazørd	hazard	1	noun	
há	hey	2	interjection	
hár	hair	2	noun	
hát	hate	2	verb	
hedák	headache	5	noun	
hed	head	1	noun	
hedkúórtørz	headquarters	6	noun	
hedlín	headline	3	noun	
hel	hell	1	noun	
helikoptør	helicopter	2	noun	
helmit	helmet	1	noun	
heló	hello	2	interjection	
helpful	helpful	0	adjective	
help	help	0	noun	
helthé	healthy	2	adjective	
helth	health	1	noun	
hens	hence	2	adverb	
heritidzh	heritage	4	noun	
hevé	heavy	2	adjective	
hevilé	heavily	2	adverb	
hevin	heaven	2	noun	
hezitát	hesitate	3	verb	
hé	he	1	pronoun	
hél	heal	2	verb	
hél	heel	2	noun	
hér	hear	2	verb	
hér	here	2	adverb	
héring	hearing	2	noun	
héró	hero	2	noun	
hét	heat	2	noun	
héúdzh	huge	5	adjective	
héúmanité	humanity	3	noun	
héúmin	human	3	adjective	
héúmør	humor	3	noun	
hidin	hidden	2	adjective	
hil	hill	1	noun	
him	him	0	pronoun	
himself	himself	0	pronoun	
hint	hint	0	noun	
hip	hip	0	noun	
Hispanik	Hispanic	1	adjective	
históréin	historian	3	noun	
histórik	historic	2	adjective	
históriklé	historically	5	adverb	
histórikul	historical	3	adjective	
histøré	history	2	noun	
hit	hit	0	noun	
hiz	his	1	article	
hí-tek	high-tech	5	adjective	
híd	hide	2	verb	
hí	high	3	adverb	
hí	hi	1	interjection	
hík	hike	2	verb	
hílé	highly	4	adverb	
hílít	highlight	6	verb	
hípothisis	hypothesis	2	noun	
hír	hire	2	verb	
hít	height	4	noun	
híúá	highway	6	noun	
ho	ha	1	interjection	
hoké	hockey	3	noun	
hol	hall	2	noun	
hol	haul	2	verb	
holidá	holiday	2	noun	
holúá	hallway	5	noun	
hord	hard	1	adverb	
hordlé	hardly	2	adverb	
hordúer	hardware	4	noun	
horm	harm	1	noun	
hormuné	harmony	3	noun	
horsh	harsh	1	adjective	
hort	heart	2	noun	
horvist	harvest	2	noun	
hospitul	hospital	1	noun	
hostidzh	hostage	4	noun	
hostul	hostile	2	adjective	
hot	hot	0	adjective	
hóld	hold	1	noun	
hólé	holy	2	adjective	
hól	hole	2	noun	
hól	whole	3	adjective	
hóm	home	2	adverb	
hómland	homeland	2	noun	
hómlis	homeless	4	adjective	
hómúørk	homework	4	noun	
hópfulé	hopefully	4	adverb	
hóp	hope	2	noun	
hóribul	horrible	4	adjective	
hórmón	hormone	3	noun	
hórn	horn	1	noun	
hórør	horror	3	noun	
hórs	horse	2	noun	
hóst	host	1	noun	
hótel	hotel	1	noun	
høk	hook	2	noun	
hørasmint	harassment	3	noun	
høré	hurry	3	verb	
hør	her	1	article	
hørikán	hurricane	5	noun	
hørízin	horizon	3	noun	
hørself	herself	1	pronoun	
hørt	hurt	1	verb	
hørz	hers	2	pronoun	
hug	hug	0	verb	
hu	huh	1	interjection	
hundrid	hundred	1	numeral	
huné	honey	3	noun	
hunggør	hunger	1	noun	
hunggré	hungry	1	adjective	
hunt	hunt	0	verb	
hunting	hunting	0	noun	
huntør	hunter	1	noun	
huzbind	husband	2	noun	
húevør	whoever	3	pronoun	
hú	who	2	pronoun	
húm	whom	2	pronoun	
húz	whose	4	determiner	
if	if	0	conjunction	
ifishint	efficient	5	adjective	
ignór	ignore	2	verb	
ilégul	illegal	3	adjective	
il	ill	1	adjective	
ilnis	illness	3	noun	
ilustrát	illustrate	3	verb	
ilúzhin	illusion	4	noun	
imadzhináshin	imagination	7	noun	
imadzhin	imagine	4	verb	
imédéit	immediate	5	adjective	
imédéitlé	immediately	6	adverb	
iméún	immune	3	adjective	
imidzh	image	4	noun	
imigráshin	immigration	5	noun	
imigrint	immigrant	2	noun	
imishin	emission	3	noun	
imóshin	emotion	5	noun	
imóshinulé	emotionally	8	adverb	
imóshinul	emotional	6	adjective	
imørdzhensé	emergency	7	noun	
imørdzh	emerge	5	verb	
imørdzhing	emerging	5	adjective	
impakt	impact	1	noun	
implikáshin	implication	5	noun	
implimentáshin	implementation	5	noun	
implimint	implement	2	verb	
implí	imply	1	verb	
imposibul	impossible	3	adjective	
impórt	import	1	noun	
impórtins	importance	4	noun	
impórtint	important	2	adjective	
impórtintlé	importantly	3	adverb	
impóz	impose	3	verb	
impres	impress	1	verb	
impreshin	impression	2	noun	
impresiv	impressive	2	adjective	
imprúvd	improved	2	adjective	
imprúv	improve	2	verb	
imprúvmint	improvement	3	noun	
impuls	impulse	1	noun	
indeks	index	2	noun	
indéd	indeed	2	adverb	
Indéin	Indian	2	adjective	
indidzhinis	indigenous	6	adjective	
indikáshin	indication	5	noun	
indikát	indicate	3	verb	
indikátør	indicator	3	noun	
indipendins	independence	4	noun	
indipendint	independent	2	adjective	
individzhúul	individual	4	adjective	
industré	industry	1	noun	
industréul	industrial	2	adjective	
indzhøré	injury	5	noun	
indzhør	injure	5	verb	
inevitibul	inevitable	3	adjective	
inevitublé	inevitably	2	adverb	
infekshin	infection	4	noun	
infint	infant	1	noun	
infláshin	inflation	4	noun	
inflúens	influence	3	noun	
inflúenshul	influential	4	adjective	
infórm	inform	1	verb	
infórmul	informal	2	adjective	
inførmáshin	information	5	noun	
infrustrukshør	infrastructure	6	noun	
in	in	0	adverb	
Ingglish	English	1	adjective	
inggrédéint	ingredient	3	noun	
inherint	inherent	1	adjective	
inherit	inherit	0	verb	
inishéát	initiate	5	verb	
inishéitiv	initiative	5	noun	
inishulé	initially	5	adverb	
inishul	initial	3	adjective	
inklúd	include	3	verb	
inklúding	including	2	preposition	
inkórpørát	incorporate	5	verb	
inkrediblé	incredibly	2	adverb	
inkredibul	incredible	3	adjective	
inkrés	increase	4	noun	
inkrésing	increasing	3	adjective	
inkrésinglé	increasingly	4	adverb	
inkrést	increased	5	adjective	
inkum	income	3	noun	
inkúiré	inquiry	3	noun	
inmát	inmate	2	noun	
inórmus	enormous	3	adjective	
inør	inner	2	adjective	
inpøt	input	1	noun	
insekt	insect	1	noun	
insentiv	incentive	2	noun	
inshørins	insurance	5	noun	
insidint	incident	2	noun	
insist	insist	0	verb	
insíd	inside	2	adverb	
insít	insight	3	noun	
insørt	insert	1	verb	
inspekshin	inspection	4	noun	
inspektør	inspector	2	noun	
inspiráshin	inspiration	4	noun	
inspír	inspire	2	verb	
insted	instead	1	adverb	
instinkt	instinct	1	noun	
instins	instance	3	noun	
instint	instant	1	adjective	
instintlé	instantly	2	adverb	
institúshin	institution	4	noun	
institúshinul	institutional	5	adjective	
instol	install	2	verb	
instrukshin	instruction	4	noun	
instrukshinul	instructional	5	adjective	
instrukt	instruct	1	verb	
instruktør	instructor	2	noun	
instrumint	instrument	1	noun	
instuláshin	installation	5	noun	
intakt	intact	1	adjective	
integrité	integrity	1	noun	
intelidzhins	intelligence	7	noun	
intelidzhint	intelligent	5	adjective	
intend	intend	0	verb	
intens	intense	1	adjective	
intenshin	intention	3	noun	
intensité	intensity	1	noun	
intent	intent	0	noun	
intéréør	interior	3	adjective	
intigráshin	integration	5	noun	
intigrát	integrate	3	verb	
intigrátid	integrated	3	adjective	
intilekshúul	intellectual	7	adjective	
intimit	intimate	2	adjective	
intørakshin	interaction	5	noun	
intørakt	interact	2	verb	
intørfér	interfere	3	verb	
intørnashinul	international	5	adjective	
intørnet	Internet	2	noun	
intørnul	internal	2	adjective	
intørpritáshin	interpretation	6	noun	
intørprit	interpret	2	verb	
intørupt	interrupt	2	verb	
intørvenshin	intervention	4	noun	
intørvéú	interview	4	noun	
intørvul	interval	2	noun	
intrist	interest	2	noun	
intristid	interested	3	adjective	
intristing	interesting	2	adjective	
intrudukshin	introduction	5	noun	
intrudús	introduce	4	verb	
intú	into	1	preposition	
inuf	enough	4	adverb	
inusint	innocent	4	adjective	
inuváshin	innovation	6	noun	
inuvátiv	innovative	4	adjective	
invád	invade	2	verb	
invázhin	invasion	4	noun	
invenshin	invention	3	noun	
invent	invent	0	verb	
inventóré	inventory	2	noun	
invest	invest	0	verb	
investigáshin	investigation	4	noun	
investigát	investigate	2	verb	
investigátør	investigator	2	noun	
investmint	investment	1	noun	
investør	investor	1	noun	
invisibul	invisible	2	adjective	
invitáshin	invitation	4	noun	
invít	invite	2	verb	
involvd	involved	1	adjective	
involv	involve	1	verb	
involvmint	involvement	2	noun	
ishéú	issue	3	noun	
Italéin	Italian	2	adjective	
it	it	0	pronoun	
itself	itself	0	pronoun	
its	its	0	article	in udhør úørdz
iuú	ie	2	adverb	
íbraú	eyebrow	5	noun	
ídentifikáshin	identification	6	noun	
ídentifí	identify	2	verb	
ídentikul	identical	3	adjective	
ídentité	identity	2	noun	
ídél	ideal	3	adjective	
ídéolidzhé	ideology	7	noun	
ídéu	idea	3	noun	
ídéulodzhikul	ideological	8	adjective	
ídhør	either	4	adverb	
í	eye	3	noun	
Í	I	1	pronoun	
íkon	icon	2	noun	
íl	aisle	4	noun	
ílind	island	3	noun	
Írish	Irish	1	adjective	
írn	iron	2	noun	
íroniklé	ironically	5	adverb	
íruné	irony	3	noun	
ís	ice	3	noun	
ísuláshin	isolation	6	noun	
ísulát	isolate	4	verb	
ísulátid	isolated	4	adjective	
ítum	item	2	noun	
kab	cab	1	noun	
kabin	cabin	1	noun	
kabinit	cabinet	2	noun	
kalindør	calendar	3	noun	
kalkéøláshin	calculation	8	noun	
kalkéølát	calculate	6	verb	
kampán	campaign	4	noun	
kamp	camp	1	noun	
kampis	campus	2	noun	
kamru	camera	3	noun	
kandé	candy	2	noun	
kandidit	candidate	3	noun	
kandul	candle	3	noun	
kan	can	1	noun	
kansør	cancer	3	noun	
kansul	cancel	3	verb	
kanvis	canvas	2	noun	
kap	cap	1	noun	
kapitul	capital	2	noun	
kapshør	capture	5	verb	
kaptin	captain	2	noun	
kash	cash	1	noun	
kast	cast	1	noun	
kat	cat	1	noun	
Kathlik	Catholic	3	adjective	
katigóré	category	4	noun	
katsh	catch	2	noun	
katul	cattle	3	noun	
katulog	catalog	2	noun	
kaú	cow	3	noun	
kaúnsul	counsel	4	noun	
kaúnsul	council	5	noun	
kaúnsuling	counseling	4	noun	
kaúnsulør	counselor	5	noun	
kaúnté	county	4	noun	
kaúnt	count	3	noun	
kaúntør	counter	4	noun	
kaúntørport	counterpart	5	noun	
kaútsh	couch	5	noun	
kazhulté	casualty	5	noun	
kazhúul	casual	5	adjective	
kábul	cable	4	noun	
kádzh	cage	5	noun	
kák	cake	3	noun	
káos	chaos	3	noun	
kápibilité	capability	4	noun	
kápibul	capable	5	adjective	
kás	case	3	noun	
káv	cave	3	noun	
kemikul	chemical	4	adjective	
kemistré	chemistry	3	noun	
keré	carry	4	verb	
keréør	carrier	5	noun	
kerfulé	carefully	5	adverb	
kerful	careful	3	adjective	
ker	care	3	noun	
keriktør	character	6	noun	
keriktøristik	characteristic	7	noun	
keriktøríz	characterize	8	verb	
kerit	carrot	4	noun	
ké	key	2	adjective	
kéøréis	curious	6	adjective	
kéøréosité	curiosity	5	noun	
kéør	cure	4	noun	
kép	keep	2	verb	
Kéúbin	Cuban	4	adjective	
kéú	cue	3	noun	
kéút	cute	4	adjective	
kid	kid	0	noun	
kik	kick	1	verb	
kil	kill	1	verb	
kiling	killing	1	noun	
kilør	killer	2	noun	
kingdum	kingdom	1	noun	
king	king	0	noun	
kis	kiss	1	noun	
kit	kit	0	noun	
kitshin	kitchen	2	noun	
kínd	kind	1	adverb	
klas	class	2	noun	
klasifí	classify	3	verb	
klasik	classic	3	adjective	
klasikul	classical	4	adjective	
klasrúm	classroom	4	noun	
klaúd	cloud	3	noun	
klá	clay	3	noun	
klám	claim	3	noun	
klén	clean	3	adjective	
klér	clear	3	adjective	
klérlé	clearly	4	adverb	
klif	cliff	2	noun	
klik	click	2	verb	
kling	cling	1	verb	
klinik	clinic	2	noun	
klinikul	clinical	3	adjective	
klip	clip	1	noun	
klíint	client	3	noun	
klím	climb	3	verb	
klímit	climate	4	noun	
klok	clock	2	noun	
kloth	cloth	1	noun	
klozit	closet	3	noun	
klódhing	clothing	3	noun	
klódhz	clothes	5	noun	
klós	close	3	adverb	
klósist	closest	3	adjective	
klóslé	closely	4	adverb	
klósør	closer	3	adjective	
klózd	closed	4	adjective	
klóz	close	4	verb	
klørk	clerk	2	noun	
klub	club	1	noun	
klustør	cluster	2	noun	
klú	clue	3	noun	
kofé	coffee	4	noun	
kognitiv	cognitive	2	adjective	
kolég	colleague	6	noun	
kol	call	3	noun	
kolidzh	college	5	noun	
koliné	colony	3	noun	
kolm	calm	2	adjective	
kolør	collar	3	noun	
kolum	column	2	noun	
kolumnist	columnist	1	noun	
kombat	combat	1	noun	
kombináshin	combination	5	noun	
komin	common	3	adjective	
kominlé	commonly	4	adverb	
komint	comment	3	noun	
kompinsáshin	compensation	6	noun	
kompitishin	competition	5	noun	
komplikátid	complicated	4	adjective	
kompréhensiv	comprehensive	3	adjective	
komprimíz	compromise	5	noun	
komprubul	comparable	5	adjective	
kompuzishin	composition	6	noun	
komudé	comedy	3	noun	
kondukt	conduct	2	noun	
konfidins	confidence	4	noun	
konfidint	confident	2	adjective	
konflikt	conflict	2	noun	
konfrins	conference	5	noun	
konfrintáshin	confrontation	6	noun	
Konggris	Congress	3	noun	
konkrét	concrete	4	adjective	
konsept	concept	2	noun	
konshins	conscience	5	noun	
konshis	conscious	4	adjective	
konshisnis	consciousness	6	noun	
konsikúens	consequence	6	noun	
konsikúentlé	consequently	5	adverb	
konsintráshin	concentration	7	noun	
konsintrát	concentrate	5	verb	
konsørt	concert	3	noun	
konsørváshin	conservation	6	noun	
konstint	constant	2	adjective	
konstintlé	constantly	3	adverb	
konstitúshin	constitution	5	noun	
konstitúshinul	constitutional	6	adjective	
konstitút	constitute	3	verb	
konstrukt	construct	2	noun	
kontakt	contact	2	noun	
kontekst	context	3	noun	
kontest	contest	1	noun	
kontinint	continent	2	noun	
kontrakt	contract	2	noun	
kontraktør	contractor	3	noun	
kontrast	contrast	1	noun	
kontribéúshin	contribution	6	noun	
kontruvørsé	controversy	4	noun	
kontruvørshul	controversial	5	adjective	
kontumplát	contemplate	4	verb	
konvikt	convict	2	verb	
konvørsáshin	conversation	6	noun	
kopé	copy	2	noun	
kop	cop	1	noun	
korbin	carbon	3	noun	
korbuhídrát	carbohydrate	6	noun	
kord	card	2	noun	
korgó	cargo	3	noun	
kor	car	2	noun	
korpit	carpet	3	noun	
kort	cart	2	noun	
kortún	cartoon	4	noun	
korv	carve	3	verb	
kost	cost	1	noun	
kostlé	costly	2	adjective	
kostúm	costume	3	noun	
kotidzh	cottage	5	noun	
kotin	cotton	3	noun	
koz	cause	5	noun	
kód	code	3	noun	
kóilishin	coalition	6	noun	
kóin	coin	2	noun	
kókán	cocaine	6	noun	
kóld	cold	2	adjective	
kól	coal	3	noun	
kóopøráshin	cooperation	7	noun	
kóopørát	cooperate	5	verb	
kóopøritiv	cooperative	5	adjective	
kóp	cope	3	verb	
kórd	cord	2	noun	
Kóréin	Korean	3	adjective	
kór	core	3	noun	
kóridór	corridor	4	noun	
kóriláshin	correlation	8	noun	
kórispondint	correspondent	5	noun	
kórn	corn	2	noun	
kórnør	corner	3	noun	
kórpøráshin	corporation	7	noun	
kórpørit	corporate	5	adjective	
kórs	coarse	4	adjective	
kórs	course	4	adverb	
kórt	court	3	noun	
kórtrúm	courtroom	5	noun	
kóst	coast	3	noun	
kóstul	coastal	4	adjective	
kót	coat	3	noun	
kótsh	coach	4	noun	
kød	could	4	verb	
køké	cookie	5	noun	
køk	cook	3	noun	
køking	cooking	3	noun	
kørekt	correct	4	adjective	
kørektlé	correctly	5	adverb	
kørér	career	4	noun	
køridzh	courage	7	noun	
kørikéølum	curriculum	6	noun	
kørinsé	currency	6	noun	
kørint	current	4	adjective	
kørintlé	currently	5	adverb	
kørtin	curtain	3	noun	
kørupshin	corruption	6	noun	
kørv	curve	3	noun	
køúórdinát	coordinate	6	verb	
køúórdinátør	coordinator	6	noun	
køúórdinits	coordinates	6	noun	
kraft	craft	1	noun	
krak	crack	2	noun	
krash	crash	1	noun	
kraúd	crowd	3	noun	
kraúdid	crowded	4	adjective	
krázé	crazy	3	adjective	
kredibilité	credibility	2	noun	
kredit	credit	1	noun	
kréáshin	creation	6	noun	
kréát	create	4	verb	
kréátiv	creative	4	adjective	
kréátivité	creativity	4	noun	
krém	cream	3	noun	
krétshør	creature	7	noun	
kriminul	criminal	2	adjective	
Krismis	Christmas	4	noun	
Kristshéanité	Christianity	6	noun	
Kristshin	Christian	5	adjective	
kristul	crystal	3	noun	
kritik	critic	2	noun	
kritikul	critical	3	adjective	
kritisizm	criticism	3	noun	
kritisíz	criticize	4	verb	
krí	cry	2	noun	
krím	crime	3	noun	
krísis	crisis	2	noun	
krítéréu	criteria	5	noun	
krol	crawl	3	verb	
kronik	chronic	3	adjective	
krop	crop	1	noun	
kros	cross	2	noun	
krush	crush	1	verb	
krú	crew	3	noun	
krúl	cruel	3	adjective	
krúshul	crucial	5	adjective	
krúz	cruise	5	noun	
kulabøráshin	collaboration	8	noun	
kulaps	collapse	4	noun	
kulekshin	collection	7	noun	
kulekt	collect	4	verb	
kulektiv	collective	5	adjective	
kulektør	collector	5	noun	
kulestørol	cholesterol	4	noun	
kulónéul	colonial	5	adjective	
kulørful	colorful	3	adjective	
kulør	color	3	noun	
kultshør	culture	5	noun	
kultshørul	cultural	5	adjective	
kumand	command	3	noun	
kumandør	commander	4	noun	
kumbínd	combined	4	adjective	
kumbín	combine	4	verb	
kuméúnikáshin	communication	9	noun	
kuméúnikát	communicate	7	verb	
kuméúnité	community	5	noun	
kumført	comfort	3	noun	
kumftørbul	comfortable	8	adjective	
kum	come	3	verb	
kuming	coming	2	adjective	
kumishin	commission	5	noun	
kumishinør	commissioner	6	noun	
kumité	committee	6	noun	
kumit	commit	3	verb	
kumitmint	commitment	4	noun	
kumodité	commodity	4	noun	
kumørshul	commercial	7	adjective	
kumpanéin	companion	4	noun	
kumpaúnd	compound	4	noun	
kumpel	compel	2	verb	
kumpeling	compelling	3	adjective	
kumper	compare	4	verb	
kumperisin	comparison	4	noun	
kumpetitiv	competitive	3	adjective	
kumpetitør	competitor	3	noun	
kumpét	compete	4	verb	
kumpéútør	computer	5	noun	
kumpiné	company	4	noun	
kumplán	complain	4	verb	
kumplánt	complaint	4	noun	
kumpleks	complex	4	adjective	
kumpleksité	complexity	5	noun	
kumplét	complete	4	adjective	
kumplétlé	completely	5	adverb	
kumplí	comply	3	verb	
kumplíins	compliance	6	noun	
kumpónint	component	4	noun	
kumpóz	compose	5	verb	
kumpríz	comprise	5	verb	
Kunádéin	Canadian	5	adjective	
kundem	condemn	3	verb	
kundishin	condition	5	noun	
kundukt	conduct	3	verb	
kunekshin	connection	7	noun	
kunekt	connect	4	verb	
kunfes	confess	3	verb	
kunfeshin	confession	4	noun	
kunféúz	confuse	5	verb	
kunféúzhin	confusion	7	noun	
kunfirm	confirm	2	verb	
kunflikt	conflict	3	verb	
kunfrunt	confront	3	verb	
kunggreshinul	congressional	5	adjective	
kunklúd	conclude	5	verb	
kunklúzhin	conclusion	7	noun	
kunsekéøtiv	consecutive	6	adjective	
kunsensis	consensus	3	noun	
kunsent	consent	2	noun	
kunsepshin	conception	6	noun	
kunséd	concede	5	verb	
kunsév	conceive	6	verb	
kunsidøráshin	consideration	7	noun	
kunsidør	consider	3	verb	
kunsidøriblé	considerably	5	adverb	
kunsidøribul	considerable	6	adjective	
kunsist	consist	2	verb	
kunsistint	consistent	3	adjective	
kunsistintlé	consistently	4	adverb	
kunsørnd	concerned	5	adjective	
kunsørn	concern	4	noun	
kunsørning	concerning	4	preposition	
kunsørvitiv	conservative	5	adjective	
kunspirisé	conspiracy	5	noun	
kunstránt	constraint	4	noun	
kunstrukshin	construction	6	noun	
kunstrukt	construct	3	verb	
kunsult	consult	2	verb	
kunsultint	consultant	3	noun	
kunsumpshin	consumption	5	noun	
kunsúm	consume	4	verb	
kunsúmør	consumer	4	noun	
kuntán	contain	4	verb	
kuntánør	container	5	noun	
kuntempøreré	contemporary	5	adjective	
kuntend	contend	2	verb	
kuntent	content	2	adjective	
kuntinéúd	continued	4	adjective	
kuntinéú	continue	4	verb	
kuntinéúing	continuing	4	adjective	
kuntinéúis	continuous	5	adjective	
kuntré	country	3	noun	
kuntribéøtør	contributor	5	noun	
kuntribéút	contribute	5	verb	
kuntról	control	3	noun	
kunvá	convey	4	verb	
kunvenshin	convention	5	noun	
kunvenshinul	conventional	6	adjective	
kunvénéins	convenience	7	noun	
kunvikshin	conviction	6	noun	
kunvins	convince	4	verb	
kunvinst	convinced	5	adjective	
kunvørt	convert	3	verb	
kunvørzhin	conversion	6	noun	
kupasité	capacity	4	noun	
kup	cup	1	noun	
kupul	couple	4	noun	
kusénó	casino	4	noun	
kustidé	custody	3	noun	
kustum	custom	2	noun	
kustumør	customer	3	noun	
kut	cut	1	noun	
kuvør	cover	3	noun	
kuvridzh	coverage	7	noun	
kuzin	cousin	3	noun	
kúest	quest	2	noun	
kúestshinár	questionnaire	8	noun	
kúestshin	question	5	noun	
kúén	queen	4	noun	
kú	coup	4	noun	
kúik	quick	3	adjective	
kúiklé	quickly	4	adverb	
kúit	quit	2	verb	
kúíit	quiet	4	adjective	
kúíitlé	quietly	5	adverb	
kúít	quite	4	adverb	
kúl	cool	3	adjective	
kúolifí	qualify	4	verb	
kúolité	quality	4	noun	
kúontité	quantity	4	noun	
kúórtørbak	quarterback	5	noun	
kúórtør	quarter	4	noun	
kúót	quote	4	noun	
lab	lab	0	noun	
labritóré	laboratory	4	noun	
ladør	ladder	2	noun	
laf	laugh	3	noun	
laftør	laughter	4	noun	
lak	lack	1	noun	
lamp	lamp	0	noun	
land	land	0	noun	
landing	landing	0	noun	
landmork	landmark	1	noun	
landskáp	landscape	3	noun	
lap	lap	0	noun	
last	last	0	adverb	
Latin	Latin	0	adjective	
latør	latter	2	determiner	
laúd	loud	2	adverb	
lábør	labor	2	noun	
lábul	label	2	noun	
ládé	lady	2	noun	
lá	lay	2	verb	
lák	lake	2	noun	
lán	lane	2	noun	
lánggúidzh	language	6	noun	
láør	layer	3	noun	
lásør	laser	2	noun	
lát	late	2	adverb	
látlé	lately	3	adverb	
látør	later	2	adverb	
led	lead	1	noun	
ledhør	leather	3	noun	
ledzhind	legend	4	noun	
ledzhisláshin	legislation	7	noun	
ledzhislátiv	legislative	5	adjective	
ledzhislátør	legislator	5	noun	
ledzhislátshør	legislature	8	noun	
left	left	0	adjective	
leg	leg	0	noun	
legisé	legacy	3	noun	
lekshør	lecture	5	noun	
lemin	lemon	1	noun	
lend	lend	0	verb	
length	length	0	noun	
lenz	lens	1	noun	
les	less	1	adverb	
lesin	lesson	2	noun	
let	let	0	verb	
letør	letter	2	noun	
levul	level	1	adjective	
léd	lead	2	verb	
léding	leading	2	adjective	
lédør	leader	3	noun	
lédørship	leadership	3	noun	
léf	leaf	2	noun	
lég	league	4	noun	
légulé	legally	4	adverb	
légul	legal	2	adjective	
lén	lean	2	verb	
lép	leap	2	verb	
lést	least	2	adverb	
lév	leave	3	noun	
libørté	liberty	2	noun	
libørul	liberal	2	adjective	
lid	lid	0	noun	
lidzhitimit	legitimate	6	adjective	
lift	lift	0	verb	
likúid	liquid	2	adjective	
lim	limb	1	noun	
limitáshin	limitation	4	noun	
limit	limit	0	noun	
limitid	limited	1	adjective	
link	link	0	noun	
lip	lip	0	noun	
lisin	listen	2	verb	
lisinør	listener	3	noun	
list	list	0	noun	
litøreré	literary	3	adjective	
litørulé	literally	4	adverb	
litørutshør	literature	6	noun	
litul	little	2	adverb	
living	living	0	adjective	
líbreré	library	3	noun	
líf	life	2	noun	
lífstíl	lifestyle	4	noun	
líftím	lifetime	4	noun	
lí	lie	2	noun	
líibilité	liability	3	noun	
líin	lion	2	noun	
lík	like	2	adverb	
líklé	likely	3	adverb	
líkléhød	likelihood	5	noun	
líkúíz	likewise	6	adverb	
lín	line	2	noun	
lísinz	license	5	noun	
lít	light	3	adjective	
líting	lighting	3	noun	
lítlé	lightly	4	adverb	
lítning	lightning	3	noun	
lív	live	2	adjective	
lívør	liver	2	noun	
lobé	lobby	2	noun	
lodzhik	logic	4	noun	
lodzhikul	logical	5	adjective	
log	log	0	noun	
lo	law	2	noun	
lok	lock	1	noun	
lomákør	lawmaker	4	noun	
londré	laundry	3	noun	
long-tørm	long-term	1	adjective	
long	long	0	adverb	
lon	lawn	2	noun	
longtím	longtime	2	adjective	
lontsh	launch	4	noun	
lordzh	large	4	adjective	
lordzhlé	largely	5	adverb	
los	loss	1	noun	
lost	lost	0	adjective	
losút	lawsuit	4	noun	
lot	lot	0	noun	
lots	lots	0	pronoun	
lód	load	2	noun	
lóéør	lawyer	4	noun	
lóéul	loyal	3	adjective	
lóéulté	loyalty	4	noun	
ló	low	2	adverb	
lókáshin	location	6	noun	
lókát	locate	4	verb	
lókul	local	3	adjective	
lón	loan	2	noun	
lónlé	lonely	3	adjective	
lóúør	lower	3	verb	
løk	look	2	noun	
lørn	learn	2	verb	
lørning	learning	2	noun	
luké	lucky	2	adjective	
luk	luck	1	noun	
lung	lung	0	noun	
luntsh	lunch	2	noun	
luv	love	2	noun	
luvlé	lovely	3	adjective	
luvør	lover	2	noun	
lúp	loop	2	noun	
lús	loose	3	adjective	
lúz	lose	3	verb	
mad	mad	0	adjective	
madzhik	magic	4	adjective	
magizén	magazine	3	noun	
magnetik	magnetic	1	adjective	
magnitúd	magnitude	2	noun	
maksimum	maximum	2	adjective	
mandát	mandate	2	noun	
manéøfaktshøring	manufacturing	6	noun	
manéøfaktshørør	manufacturer	7	noun	
manéúul	manual	3	noun	
man	man	0	noun	
manidzh	manage	4	verb	
manidzhing	managing	4	adjective	
manidzhmint	management	5	noun	
manidzhør	manager	5	noun	
manør	manner	2	noun	
manshin	mansion	2	noun	
map	map	0	noun	
mas	mass	1	adjective	
masiv	massive	2	adjective	
mask	mask	0	noun	
mastør	master	1	noun	
math	math	0	noun	
mathmatiks	mathematics	2	noun	
matør	matter	2	noun	
matsh	match	1	noun	
maúnt	mount	2	verb	
maúntin	mountain	3	noun	
maús	mouse	3	noun	
maúth	mouth	2	noun	
mábé	maybe	3	adverb	
mádzhør	major	5	adjective	
má	may	2	verb	
mák	make	2	verb	
mákør	maker	2	noun	
mákup	makeup	2	noun	
mál	mail	2	noun	
mál	male	2	adjective	
mán	main	2	adjective	
mánlé	mainly	3	adverb	
mánstrém	mainstream	4	adjective	
mántán	maintain	4	verb	
mántinins	maintenance	6	noun	
máør	mayor	3	noun	
mát	mate	2	noun	
medikáshin	medication	5	noun	
medikul	medical	2	adjective	
medisin	medicine	2	noun	
medul	medal	1	noun	
mekinism	mechanism	3	noun	
Meksikin	Mexican	4	adjective	
melt	melt	0	verb	
membør	member	1	noun	
membørship	membership	1	noun	
memøré	memory	2	noun	
mené	many	2	determiner	
menéú	menu	2	noun	
menshin	mention	3	noun	
mentór	mentor	1	noun	
mentulé	mentally	3	adverb	
mentul	mental	1	adjective	
meréd	married	4	adjective	
meré	marry	3	verb	
meridzh	marriage	5	noun	
merit	merit	0	noun	
mes	mess	1	noun	
mesidzh	message	4	noun	
methid	method	1	noun	
metifór	metaphor	4	noun	
metrupolitin	metropolitan	2	adjective	
metul	metal	1	noun	
mezhør	measure	4	noun	
mezhørmint	measurement	5	noun	
médéu	media	3	noun	
médéum	medium	2	adjective	
mé	me	1	pronoun	
mél	meal	2	noun	
mén	mean	2	adjective	
méningful	meaningful	2	adjective	
méning	meaning	2	noun	
méntím	meantime	4	noun	
ménúíl	meanwhile	6	adverb	
ménz	means	3	noun	
mér	mere	2	adjective	
mérikul	miracle	5	noun	
mérlé	merely	3	adverb	
mét	meat	2	noun	
mét	meet	2	verb	
méting	meeting	2	noun	
métør	meter	2	noun	
méúnisipul	municipal	4	adjective	
méútshúul	mutual	6	adjective	
méúzéim	museum	5	noun	
méúzik	music	4	noun	
méúzikul	musical	5	adjective	
méúzishin	musician	6	noun	
midnít	midnight	3	noun	
midst	midst	0	noun	
midul	middle	2	adjective	
mikanik	mechanic	4	noun	
mikanikul	mechanical	5	adjective	
miks	mix	2	noun	
mikst	mixed	3	adjective	
mikstshør	mixture	6	noun	
miléin	million	2	numeral	
mil	mill	1	noun	
militeré	military	2	adjective	
milk	milk	0	noun	
minimíz	minimize	2	verb	
minimul	minimal	1	adjective	
minimum	minimum	0	adjective	
minirul	mineral	2	noun	
ministør	minister	1	noun	
ministré	ministry	1	noun	
minit	minute	2	noun	
mirør	mirror	2	noun	
mis	miss	1	verb	
mishineré	missionary	4	noun	
mishin	mission	2	noun	
mising	missing	1	adjective	
misták	mistake	2	noun	
mistéréis	mysterious	5	adjective	
mistiré	mystery	3	noun	
misul	missile	3	noun	
mith	myth	1	noun	
mí	my	1	article	
mígráshin	migration	5	noun	
míld	mild	1	adjective	
mínd	mind	1	noun	
mín	mine	2	noun	
mínórité	minority	3	noun	
mínør	minor	2	adjective	
míself	myself	1	pronoun	
mít	might	3	verb	
modifí	modify	1	verb	
modist	modest	1	adjective	
modørit	moderate	3	adjective	
modørn	modern	1	adjective	
modul	model	1	noun	
mol	mall	2	noun	
molikéúl	molecule	5	noun	
mom	mom	0	noun	
monéømint	monument	3	noun	
monitør	monitor	1	noun	
monstør	monster	1	noun	
morbul	marble	3	noun	
mordzhin	margin	4	noun	
mork	mark	1	noun	
morkit	market	2	noun	
morkiting	marketing	2	noun	
morkitplás	marketplace	5	noun	
morkør	marker	2	noun	
mortsh	march	3	verb	
móbul	mobile	3	adjective	
mód	mode	2	noun	
mómentum	momentum	1	noun	
mómint	moment	2	noun	
mórgidzh	mortgage	6	noun	
mór	more	2	adverb	
mórning	morning	1	noun	
móróvør	moreover	4	adverb	
mórtalité	mortality	2	noun	
mórul	moral	2	adjective	
móshin	motion	4	noun	
móst	most	1	adverb	
móstlé	mostly	2	adverb	
mótiváshin	motivation	5	noun	
mótivát	motivate	3	verb	
mótiv	motive	2	noun	
mótør	motor	2	noun	
mørdør	murder	2	noun	
mørén	marine	3	adjective	
mørtshint	merchant	4	noun	
mud	mud	0	noun	
mudzhórité	majority	6	noun	
multipul	multiple	2	adjective	
Mundá	Monday	3	noun	
muné	money	3	noun	
munipéølát	manipulate	5	verb	
munké	monkey	3	noun	
munth	month	1	noun	
munthlé	monthly	2	adjective	
mushén	machine	4	noun	
mushrúm	mushroom	2	noun	
must	must	0	verb	
musul	muscle	2	noun	
mutériéul	material	4	noun	
muthør	mother	2	noun	
mutør	mutter	2	verb	
mutsh	much	2	adverb	
múd	mood	2	noun	
mún	moon	2	noun	
múvé	movie	3	noun	
múv	move	2	noun	
múvmint	movement	3	noun	
nashinul	national	4	adjective	
nasté	nasty	1	adjective	
natshørulé	naturally	6	adverb	
natshørul	natural	4	adjective	
naú	now	2	adverb	
nábør	neighbor	5	noun	
nábørhød	neighborhood	7	noun	
nábøring	neighboring	5	adjective	
nákid	naked	2	adjective	
nál	nail	2	noun	
nám	name	2	noun	
náshin	nation	4	noun	
náshinúíd	nationwide	7	adverb	
nátiv	native	2	adjective	
nátshør	nature	5	noun	
návul	naval	2	adjective	
negitiv	negative	2	adjective	
nek	neck	1	noun	
nekst	next	2	numeral	
neritiv	narrative	4	noun	
neró	narrow	4	adjective	
nesiseré	necessary	5	adjective	
nesiserilé	necessarily	5	adverb	
nest	nest	0	noun	
net	net	0	adjective	
netúørk	network	2	noun	
nevør-dhe-les	nevertheless	5	adverb	
nevør	never	1	adverb	
néd	need	2	noun	
nédhør	neither	4	adverb	
nédul	needle	4	noun	
né	knee	3	noun	
nél	kneel	3	verb	
nérbí	nearby	3	adverb	
nér	near	2	adverb	
nérlé	nearly	3	adverb	
nét	neat	2	adjective	
nigóshéáshin	negotiation	9	noun	
nigóshéát	negotiate	7	verb	
nisesité	necessity	4	noun	
níf	knife	3	noun	
nín	nine	2	numeral	
nís	nice	3	adjective	
nít	night	3	noun	
nítmár	nightmare	5	noun	
nod	nod	0	verb	
nok	knock	2	verb	
nolidzh	knowledge	5	noun	
nomináshin	nomination	4	noun	
nominé	nominee	2	noun	
nonprofit	nonprofit	0	adjective	
not	not	0	suffix	
novul	novel	1	noun	
nóbudé	nobody	3	pronoun	
nó	know	3	verb	
nó	no	1	article	
nóiz	noise	3	noun	
nón	known	3	adjective	
nórdhørn	northern	3	adjective	
nór	nor	1	conjunction	
nórm	norm	1	noun	
nórmulé	normally	4	adverb	
nórmul	normal	2	adjective	
nórthést	northeast	3	noun	
nórth	north	1	noun	
nórthúest	northwest	2	noun	
nóshin	notion	4	noun	
nótbøk	notebook	4	noun	
nót	note	2	noun	
nótis	notice	3	noun	
nóúer	nowhere	4	adverb	
nóz	nose	3	noun	
nørs	nurse	2	noun	
nørv	nerve	2	noun	
nørvis	nervous	3	adjective	
numbør	number	1	noun	
nun-dhe-les	nonetheless	5	adverb	
nun	none	2	pronoun	
nut	nut	0	noun	
nuthing	nothing	1	pronoun	
nú	new	2	adjective	
núklér	nuclear	4	adjective	
núlé	newly	3	adverb	
númøris	numerous	4	adjective	
nún	noon	2	noun	
nútréint	nutrient	3	noun	
nútrul	neutral	3	adjective	
núz	news	3	noun	
núzpápør	newspaper	5	noun	
obligáshin	obligation	4	noun	
obstikul	obstacle	4	noun	
obvéis	obvious	3	adjective	
obvéislé	obviously	4	adverb	
obzørváshin	observation	6	noun	
odéins	audience	6	noun	
od	odd	1	adjective	
odz	odds	2	noun	
of	off	1	adverb	
ofin	often	2	adverb	
ofis	office	3	noun	
ofisør	officer	3	noun	
ofør	offer	2	noun	
oføring	offering	2	noun	
oful	awful	2	adjective	
o	ah	2	interjection	
okéøpáshin	occupation	7	noun	
okéøpí	occupy	4	verb	
okshin	auction	5	noun	
oksidzhen	oxygen	6	noun	
oldhó	although	6	conjunction	
ol	all	2	adverb	
olmóst	almost	2	adverb	
olredé	already	3	adverb	
olsó	also	2	adverb	
oltør	alter	2	verb	
oltørnitiv	alternative	4	adjective	
oltugedhør	altogether	4	adverb	
olúáz	always	5	adverb	
Omerikin	American	3	adjective	
on	on	0	adverb	
on-góing	ongoing	1	adjective	
onist	honest	2	adjective	
onistlé	honestly	3	adverb	
onlín	online	2	adverb	
onør	honor	2	noun	
ont	aunt	2	noun	
ontrepenúr	entrepreneur	4	noun	
ontú	onto	1	preposition	
onvelóp	envelope	3	noun	
opøráshin	operation	5	noun	
opørát	operate	3	verb	
opøráting	operating	2	noun	
opørátør	operator	3	noun	
opørtúnité	opportunity	4	noun	
opru	opera	2	noun	
opshin	option	3	noun	
opt	opt	0	verb	
optimistik	optimistic	1	adjective	
opuzishin	opposition	6	noun	
opuzit	opposite	4	adjective	
orgéú	argue	3	verb	
orgéúmint	argument	4	noun	
orkitekshør	architecture	8	noun	
orkitekt	architect	4	noun	
ormd	armed	2	adjective	
ormé	army	2	noun	
orm	arm	1	noun	
ort	art	1	noun	
ortifakt	artifact	2	noun	
ortifishul	artificial	4	adjective	
ortikéølát	articulate	6	verb	
ortikul	article	4	noun	
ortist	artist	1	noun	
ortistik	artistic	2	adjective	
ot	ought	3	verb	
othør	author	3	noun	
othøríz	authorize	5	verb	
otó	auto	3	noun	
otumatik	automatic	4	adjective	
otumatiklé	automatically	7	adverb	
otumubél	automobile	6	noun	
ó	oh	2	interjection	
ó	owe	3	verb	
óil	oil	1	noun	
óká	okay	3	adverb	
ók	oak	2	noun	
óld-fashind	old-fashioned	3	adjective	
óld	old	1	adjective	
ón	own	2	verb	
ónlé	only	2	adverb	
ónør	owner	3	noun	
ónørship	ownership	3	noun	
ópin	open	2	adjective	
ópining	opening	2	noun	
ópinlé	openly	3	adverb	
órbit	orbit	1	noun	
órdineré	ordinary	3	adjective	
órdør	order	2	noun	
óréintáshin	orientation	7	noun	
órganik	organic	2	adjective	
órgin	organ	2	noun	
órginism	organism	2	noun	
órginizáshin	organization	6	noun	
órginizáshinul	organizational	7	adjective	
órginízd	organized	4	adjective	
órginíz	organize	4	verb	
ór	or	1	conjunction	
óridzhin	origin	4	noun	
órindzh	orange	5	adjective	
órul	oral	2	adjective	
óshin	ocean	4	noun	
óvør	over	2	adverb	
óvørkum	overcome	5	verb	
óvørløk	overlook	4	verb	
óvørnít	overnight	5	adverb	
óvørol	overall	4	adverb	
óvørsé	oversee	4	verb	
óvørúelm	overwhelm	4	verb	
óvørúelming	overwhelming	4	adjective	
ørb	herb	2	noun	
ørbin	urban	2	adjective	
ørdzh	urge	4	verb	
ørlé	early	3	adverb	
ørn	earn	2	verb	
ørninks	earnings	3	noun	
ørth	earth	2	noun	
ørthkúák	earthquake	6	noun	
pad	pad	0	noun	
pak	pack	1	noun	
pakidzh	package	5	noun	
palis	palace	3	noun	
pan	pan	0	noun	
panik	panic	1	noun	
pants	pants	0	noun	
panul	panel	1	noun	
pas	pass	1	noun	
pashin	passion	2	noun	
pasidzh	passage	4	noun	
pasindzhør	passenger	6	noun	
pasing	passing	1	adjective	
past	past	0	adverb	
pat	pat	0	verb	
path	path	0	noun	
patint	patent	1	noun	
patørn	pattern	2	noun	
patsh	patch	1	noun	
paúdør	powder	3	noun	
paúnd	pound	2	noun	
paúørful	powerful	3	adjective	
paúør	power	3	noun	
pádzh	page	4	noun	
pá	pay	2	noun	
pál	pale	2	adjective	
pámint	payment	3	noun	
pánful	painful	2	adjective	
pán	pain	2	noun	
pánt	paint	2	noun	
pánting	painting	2	noun	
pántør	painter	3	noun	
pápør	paper	2	noun	
pár	pair	2	noun	
pás	pace	3	noun	
páshins	patience	6	noun	
páshint	patient	4	adjective	
pátrin	patron	2	noun	
pen	pen	0	noun	
penshin	pension	2	noun	
pensul	pencil	2	noun	
penulté	penalty	2	noun	
pepør	pepper	2	noun	
perint	parent	2	noun	
pesint	peasant	2	noun	
pet	pet	0	noun	
péanó	piano	2	noun	
pék	peak	2	noun	
pél	peel	2	verb	
pénut	peanut	2	noun	
pépul	people	4	noun	
péréid	period	3	noun	
pér	peer	2	noun	
pésful	peaceful	4	adjective	
pés	peace	4	noun	
pés	piece	4	noun	
pétso	pizza	4	noun	
péúr	pure	3	adjective	
pig	pig	0	noun	
pik	pick	1	verb	
pikshør	picture	5	noun	
pikup	pickup	1	noun	
pil	pill	1	noun	
piló	pillow	3	noun	
pin	pin	0	noun	
pink	pink	0	adjective	
pistul	pistol	1	noun	
pit	pit	0	noun	
pitsh	pitch	1	noun	
pitshør	pitcher	2	noun	
pí	pie	2	noun	
píl	pile	2	noun	
pílit	pilot	2	noun	
pín	pine	2	noun	
píp	pipe	2	noun	
píunér	pioneer	4	noun	pørsinul kumpéútør
PK	PC	1	noun	
plan	plan	0	noun	
planing	planning	1	noun	
planit	planet	1	noun	
planør	planner	2	noun	
plant	plant	0	noun	
plastik	plastic	1	noun	
platfórm	platform	1	noun	
plá	play	2	noun	
plán	plain	2	adjective	
plán	plane	2	noun	
plántif	plaintiff	3	noun	
pláof	playoff	3	noun	
pláør	player	3	noun	
plás	place	3	noun	
plásmint	placement	4	noun	
plát	plate	2	noun	
plenté	plenty	1	pronoun	
plezhør	pleasure	4	noun	
plezint	pleasant	3	adjective	
pléd	plead	2	verb	
plé	plea	2	noun	
plézd	pleased	4	adjective	
pléz	please	4	adverb	
plot	plot	0	noun	
plundzh	plunge	3	verb	
plus	plus	0	preposition	
pokit	pocket	2	noun	
polisé	policy	2	noun	
politiks	politics	1	noun	
politishin	politician	3	noun	
polm	palm	1	noun	
pond	pond	0	noun	
popéøláshin	population	6	noun	
popéølerité	popularity	4	noun	
popéølør	popular	3	adjective	
pop	pop	0	noun	
pork	park	1	noun	
porking	parking	1	noun	
porshulé	partially	6	adverb	
porshul	partial	4	adjective	
porté	party	2	noun	
port	part	1	adverb	
portikéølør	particular	5	adverb	
portikéølørlé	particularly	6	adverb	
portikul	particle	4	noun	
portisipáshin	participation	6	noun	
portisipát	participate	4	verb	
portisipent	participant	3	noun	
portlé	partly	2	adverb	
portnør	partner	2	noun	
portnørship	partnership	2	noun	
posibilité	possibility	2	noun	
posiblé	possibly	2	adverb	
posibul	possible	3	adjective	
posto	pasta	2	noun	
pot	pot	0	noun	
povørté	poverty	2	noun	
poz	pause	4	noun	
pozitiv	positive	2	adjective	
póint	point	1	noun	
pók	poke	2	verb	
pól	pole	2	noun	
pól	poll	2	noun	
pór	poor	2	adjective	
pór	pour	2	verb	
pórk	pork	1	noun	
pórshin	portion	4	noun	
pórtfóléó	portfolio	4	noun	
pórt	port	1	noun	
pórtrá	portray	3	verb	
pórtrit	portrait	2	noun	
pórtsh	porch	3	noun	
póst	post	1	noun	
póstør	poster	2	noun	
póum	poem	2	noun	
póúit	poet	3	noun	
póúitré	poetry	4	noun	
póz	pose	3	verb	
pørád	parade	3	noun	
pørentul	parental	2	adjective	
pørfikt	perfect	3	adjective	
pørfiktlé	perfectly	4	adverb	
pørfórm	perform	2	verb	
pørfórmins	performance	5	noun	
pørfórmør	performer	3	noun	
pør	per	1	preposition	
pørhaps	perhaps	1	adverb	
pørminint	permanent	3	adjective	
pørmishin	permission	3	noun	
pørmit	permit	1	noun	
pørpis	purpose	3	noun	
pørpul	purple	3	adjective	
pørsentidzh	percentage	6	noun	
pørsepshin	perception	5	noun	
pørsévd	perceived	5	adjective	
pørsév	perceive	5	verb	
pørs	purse	2	noun	
pørsinalité	personality	3	noun	
pørsinel	personnel	3	noun	
pørsin	person	2	noun	
pørsinulé	personally	5	adverb	
pørsinul	personal	3	adjective	
pørsist	persist	1	verb	
pørspektiv	perspective	3	noun	
pørsúád	persuade	4	verb	
pørsú	pursue	3	verb	
pørsút	pursuit	3	noun	
pørtshis	purchase	5	noun	
Pørzhin	Persian	4	adjective	
pøsh	push	1	verb	
pøt	put	1	verb	
praktiklé	practically	5	adverb	
praktikul	practical	3	adjective	
praktis	practice	3	noun	
praktishinør	practitioner	5	noun	
praúd	proud	2	adjective	
prá	pray	2	verb	
prá	pray	2	verb	
prár	prayer	3	noun	
práz	praise	4	noun	
preditør	predator	2	noun	
prefrins	preference	4	noun	
pregninsé	pregnancy	3	noun	
pregnint	pregnant	1	adjective	
premis	premise	1	noun	
prepøráshin	preparation	5	noun	
pres	press	1	noun	
preshis	precious	4	adjective	
preshør	pressure	3	noun	
prezidenshul	presidential	4	adjective	
prezidinsé	presidency	4	noun	
prezidint	president	2	noun	
prezins	presence	4	noun	
prezintáshin	presentation	6	noun	
préméum	premium	2	noun	
prést	priest	2	noun	
prétsh	preach	3	verb	
prévéis	previous	4	adjective	
prévéislé	previously	5	adverb	
pridikshin	prediction	5	noun	
pridikt	predict	2	verb	
prifør	prefer	2	verb	
prilimineré	preliminary	3	adjective	
prinsipul	principal	2	adjective	
prinsipul	principle	3	noun	
print	print	0	noun	
pripár	prepare	3	verb	
prisís	precise	4	adjective	
prisíslé	precisely	5	adverb	
priskripshin	prescription	5	noun	
pritend	pretend	1	verb	
prité	pretty	3	adverb	
privál	prevail	3	verb	
privenshin	prevention	4	noun	
privent	prevent	1	verb	
privlidzh	privilege	5	noun	
prizent	present	2	adjective	
prizent	present	2	verb	
prizin	prison	2	noun	
prizinør	prisoner	3	noun	
prizørv	preserve	4	verb	
prizúmublé	presumably	5	adverb	
príd	pride	2	noun	
prímeré	primary	3	adjective	
prímerilé	primarily	3	adverb	
prím	prime	2	adjective	
príórité	priority	3	noun	
príør	prior	2	adjective	
prís	price	3	noun	
prívisé	privacy	4	noun	
prívit	private	3	adjective	
prívitlé	privately	4	adverb	
príz	prize	2	noun	
problum	problem	1	noun	
probublé	probably	2	adverb	
produkt	product	1	noun	
produktivité	productivity	2	noun	
prodzhekt	project	4	noun	
profit	profit	0	noun	
progres	progress	1	noun	
prominint	prominent	1	adjective	
promis	promise	1	noun	
promising	promising	0	adjective	
prompt	prompt	0	verb	
propør	proper	1	adjective	
propørlé	properly	2	adverb	
propørté	property	2	noun	
proses	process	2	noun	
prosesing	processing	2	noun	
prosesør	processor	3	noun	
prosikéúshin	prosecution	7	noun	
prosikéútør	prosecutor	5	noun	
prospekt	prospect	1	noun	
provins	province	2	noun	
pródús	produce	4	noun	
prófaúnd	profound	3	adjective	
prófíl	profile	3	noun	
prógram	program	1	noun	
prógraming	programming	2	noun	
próhibit	prohibit	1	verb	
próklám	proclaim	4	verb	
prótest	protest	1	noun	
prótén	protein	3	noun	
prótikul	protocol	4	noun	
prudukshin	production	5	noun	
pruduktiv	productive	3	adjective	
prudús	produce	4	verb	
prudúsør	producer	4	noun	
prudzhekshin	projection	8	noun	
prudzhekt	project	5	verb	
prufeshin	profession	3	noun	
prufeshinul	professional	4	adjective	
prufesør	professor	3	noun	
prugres	progress	2	verb	
prugresiv	progressive	3	adjective	
prumóshin	promotion	5	noun	
prumót	promote	3	verb	
prupórshin	proportion	5	noun	
prupózd	proposed	4	adjective	
prupóz	propose	4	verb	
prupózul	proposal	4	noun	
pruséd	proceed	4	verb	
prusédzhør	procedure	7	noun	
prutekshin	protection	5	noun	
prutekt	protect	2	verb	
prutektiv	protective	3	adjective	
pruvizhin	provision	4	noun	
pruvíd	provide	3	verb	
pruvídid	provided	3	conjunction	
pruvídør	provider	3	noun	
pruvók	provoke	3	verb	
prúf	proof	2	noun	
prúv	prove	2	verb	
publikáshin	publication	5	noun	
publik	public	1	adverb	
publiklé	publicly	2	adverb	
publish	publish	0	verb	
publishør	publisher	1	noun	
publisité	publicity	2	noun	
pulés	police	4	noun	
pulésmin	policeman	5	noun	
pul	pull	1	verb	
pulitiklé	politically	5	adverb	
pulitikul	political	3	adjective	
puls	pulse	1	noun	
pulúshin	pollution	5	noun	
pump	pump	0	noun	
punish	punish	0	verb	
punishmint	punishment	1	noun	
puntsh	punch	2	verb	
putátó	potato	3	noun	
putenshulé	potentially	6	adverb	
putenshul	potential	4	adjective	
putról	patrol	2	noun	
puzes	possess	4	verb	
puzeshin	possession	5	noun	
puzishin	position	5	noun	
puzul	puzzle	2	noun	
púl	pool	2	noun	
rabit	rabbit	1	noun	
radhør	rather	2	adverb	
radikul	radical	2	adjective	
rak	rack	1	noun	
ralé	rally	2	noun	
randum	random	1	adjective	
rantsh	ranch	2	noun	
rap	wrap	1	verb	
rapid	rapid	0	adjective	
rapidlé	rapidly	1	adverb	
rashinul	rational	4	adjective	
rat	rat	0	noun	
raúnd	round	2	adjective	
raút	route	3	noun	
rádéáshin	radiation	6	noun	
rádéó	radio	3	noun	
rádor	radar	2	noun	
rádzh	rage	4	noun	
rál	rail	2	noun	
rálród	railroad	4	noun	
rándzh	range	4	noun	
rán	rain	2	noun	
ránk	rank	1	noun	
ráp	rape	2	noun	
rás	race	3	noun	
ráshéó	ratio	5	noun	
ráshul	racial	4	adjective	
rásizm	racism	3	noun	
rát	rate	2	noun	
ráting	rating	1	noun	
ráz	raise	4	verb	
rebul	rebel	1	noun	
redé	ready	2	adjective	
red	red	0	adjective	
redilé	readily	2	adverb	
redzhistør	register	4	verb	
reféúdzhé	refugee	6	noun	
reféúdzh	refuge	5	noun	
reførens	reference	3	noun	
regéøláshin	regulation	6	noun	
regéølát	regulate	4	verb	
regéølátør	regulator	4	noun	
regéølør	regular	3	adjective	
regéølørlé	regularly	4	adverb	
regéølutóré	regulatory	5	adjective	
rekørd	record	2	noun	
rekugnishin	recognition	5	noun	
rekugníz	recognize	4	verb	
rekumend	recommend	3	verb	
rekumindáshin	recommendation	8	noun	
relitiv	relative	2	adjective	
relitivlé	relatively	3	adverb	
relivint	relevant	2	adjective	
relm	realm	1	noun	
rendør	render	1	verb	
rent	rent	0	noun	
rentul	rental	1	noun	
repéøtáshin	reputation	6	noun	
reprizent	represent	2	verb	
reprizentitiv	representative	4	adjective	
reprizintáshin	representation	7	noun	
rer	rare	2	adjective	
rerlé	rarely	3	adverb	
resipé	recipe	2	noun	
reskéú	rescue	3	noun	
rest	rest	0	noun	
restront	restaurant	3	noun	
retørik	rhetoric	3	noun	
revenú	revenue	2	noun	
revuláshin	revelation	5	noun	
revulúshineré	revolutionary	7	adjective	
revulúshin	revolution	5	noun	
rezidens	residence	3	noun	
rezidenshul	residential	4	adjective	
rezident	resident	1	noun	
rezilúshin	resolution	6	noun	
rezørváshin	reservation	6	noun	
rezumá	resume	2	noun	
réakshin	reaction	5	noun	
réakt	react	2	verb	
réalité	reality	2	noun	
rébild	rebuild	2	verb	
réd	read	2	verb	
réding	reading	2	noun	
rédør	reader	3	noun	
rédzhekt	reject	5	verb	
rédzhin	region	5	noun	
rédzhinul	regional	6	adjective	
réhubilitáshin	rehabilitation	6	noun	
réinfórs	reinforce	4	verb	
rékol	recall	4	noun	
rél	real	2	adjective	
réølistik	realistic	3	adjective	
réølíz	realize	4	verb	
rér	rear	2	adjective	
résint	recent	3	adjective	
résintlé	recently	4	adverb	
résórs	resource	5	noun	
résørtsh	research	5	noun	
résørtshør	researcher	6	noun	
rétál	retail	3	adjective	
rétálør	retailer	4	noun	
rétsh	reach	3	noun	
rézin	reason	4	noun	
rézinibul	reasonable	7	adjective	
rib	rib	0	noun	
ribin	ribbon	2	noun	
rid	rid	0	verb	
ridikéølis	ridiculous	5	adjective	
ridthm	rhythm	2	noun	
ridukshin	reduction	5	noun	
ridús	reduce	4	verb	
ridzh	ridge	2	noun	
riféúz	refuse	4	verb	
riflekshin	reflection	5	noun	
riflekt	reflect	2	verb	
rifórm	reform	2	noun	
rifør	refer	2	verb	
rifridzhørátør	refrigerator	7	noun	
rigán	regain	3	verb	
rigord	regard	2	noun	
rigording	regarding	2	preposition	
rigordlis	regardless	4	adverb	
rigret	regret	1	verb	
rikol	recall	4	verb	
rikórd	record	3	verb	
rikórding	recording	3	noun	
rikrút	recruit	4	verb	
rikuvøré	recovery	5	noun	
rikuvør	recover	4	verb	
rikúest	request	3	noun	
rikúírd	required	5	adjective	
rikúír	require	5	verb	
rikúírmint	requirement	6	noun	
rilaks	relax	3	verb	
riláshin	relation	5	noun	
riláshinship	relationship	5	noun	
rilát	relate	3	verb	
rilátid	related	3	adjective	
riléf	relief	3	noun	
rilé	really	4	adverb	
rilés	release	4	noun	
rilév	relieve	4	verb	
rilidzhin	religion	5	noun	
rilidzhis	religious	5	adjective	
rilí	rely	2	verb	
rilíibilité	reliability	4	noun	
rilíibul	reliable	5	adjective	
riluktint	reluctant	3	adjective	
rimán	remain	3	verb	
rimáning	remaining	3	adjective	
rimembør	remember	2	verb	
rim	rim	0	noun	
rimínd	remind	2	verb	
rimíndør	reminder	3	noun	
rimork	remark	2	noun	
rimorkubul	remarkable	5	adjective	
rimót	remote	3	adjective	
rimúv	remove	3	verb	
rimúvul	removal	3	noun	
ring	ring	0	noun	
ripár	repair	3	noun	
ripét	repeat	3	verb	
ripétidlé	repeatedly	5	adverb	
rip	rip	0	verb	
riplás	replace	4	verb	
riplásmint	replacement	5	noun	
riplí	reply	2	verb	
ripórt	report	2	noun	
ripórtidlé	reportedly	4	adverb	
ripórting	reporting	2	noun	
ripórtør	reporter	3	noun	
ripublik	republic	2	noun	
ripublikin	republican	3	adjective	
risepshin	reception	5	noun	
riseshin	recession	4	noun	
risév	receive	5	verb	
risévør	receiver	5	noun	
risipéint	recipient	4	noun	
riské	risky	1	adjective	
risk	risk	0	noun	
rispekt	respect	2	noun	
rispektivlé	respectively	4	adverb	
rispond	respond	1	verb	
rispondint	respondent	2	noun	
rispons	response	2	noun	
risponsibilité	responsibility	2	noun	
risponsibul	responsible	3	adjective	
rist	wrist	1	noun	
ristór	restore	3	verb	
ristrikshin	restriction	5	noun	
ristrikt	restrict	2	verb	
ritán	retain	3	verb	
ritin	written	3	adjective	
ritírd	retired	3	adjective	
ritír	retire	3	verb	
ritírmint	retirement	4	noun	
ritørn	return	2	noun	
ritrét	retreat	3	noun	
ritsh	rich	2	adjective	
ritshúul	ritual	4	noun	
riúórd	reward	3	noun	
rivél	reveal	3	verb	
rivéú	review	4	noun	
rivør	river	1	noun	
rivørs	reverse	3	verb	
rizembul	resemble	4	verb	
rizhém	regime	5	noun	
rizist	resist	2	verb	
rizistins	resistance	5	noun	
rizín	resign	4	verb	
rizolv	resolve	3	verb	
rizórt	resort	3	noun	
rizørv	reserve	4	noun	
rizult	result	2	noun	
rizúm	resume	4	verb	
ríd	ride	2	noun	
rídør	rider	2	noun	
ríful	rifle	3	noun	
ríit	riot	2	noun	
rís	rice	3	noun	
rít	right	3	adverb	
rít	write	3	verb	
ríting	writing	2	noun	
rítør	writer	3	noun	
rívul	rival	2	noun	
ríz	rise	3	noun	
rod	rod	0	noun	
ro	raw	2	adjective	
rok	rock	1	noun	
rokit	rocket	2	noun	
rong	wrong	1	adverb	
róbot	robot	1	noun	
ród	road	2	noun	
róéul	royal	3	adjective	
ró	row	2	noun	
ról	role	2	noun	
ról	roll	2	noun	
róling	rolling	2	adjective	
rómans	romance	3	noun	
rómantik	romantic	2	adjective	
Rómin	Roman	2	adjective	
róp	rope	2	noun	
róz	rose	3	noun	
røf	roof	2	noun	
rørul	rural	2	adjective	
rub	rub	0	verb	
rubør	rubber	2	adjective	
ruf	rough	3	adjective	
ruflé	roughly	4	adverb	
run	run	0	noun	
runing	running	1	adjective	
runør	runner	2	noun	
rush	rush	0	noun	
Rushin	Russian	2	adjective	
rúf	roof	2	noun	
rúin	ruin	1	verb	
rúl	rule	2	noun	
rúling	ruling	1	noun	
rúm	room	2	noun	
rúmør	rumor	2	noun	
rútén	routine	4	noun	
rúténlé	routinely	5	adverb	
rút	root	2	noun	
rút	route	3	noun	
sad	sad	0	adjective	
sak	sack	1	noun	
sakrifís	sacrifice	4	noun	
salid	salad	1	noun	
saløré	salary	2	noun	
samin	salmon	2	noun	
sampul	sample	2	noun	
sand	sand	0	noun	
sandúitsh	sandwich	3	noun	
satisfakshin	satisfaction	4	noun	
satisfí	satisfy	1	verb	
Satørdá	Saturday	3	noun	
satulít	satellite	4	noun	
saúnd	sound	2	noun	
saúthést	southeast	4	noun	
saúth	south	2	noun	
saúthúest	southwest	3	noun	
sáf	safe	2	adjective	
sáflé	safely	3	adverb	
sáfté	safety	3	noun	
sá	say	2	verb	
sák	sake	2	noun	
sákrid	sacred	3	adjective	
sál	sail	2	verb	
sál	sale	2	noun	
sálz	sales	3	noun	
sám	same	2	determiner	
sánkshin	sanction	5	noun	
sáv	save	2	verb	
sáving	saving	1	noun	
segmint	segment	1	noun	
sekéølør	secular	4	adjective	
sekéør	secure	4	adjective	
sekéørité	security	4	noun	
sekind	second	2	noun	
sekriteré	secretary	4	noun	
sekshin	section	4	noun	
sektør	sector	2	noun	
sekunderé	secondary	4	adjective	
seldum	seldom	1	adverb	
self-estém	self-esteem	2	noun	
self	self	0	noun	
sel	sell	1	verb	
sel	cell	2	noun	
selør	seller	2	noun	
selubráshin	celebration	6	noun	
selubrát	celebrate	4	verb	
seminor	seminar	1	noun	
semiteré	cemetery	3	noun	
send	send	0	verb	
Senit	Senate	2	noun	
senitór	senator	2	noun	
sensáshin	sensation	4	noun	
sens	sense	1	noun	
sensitiv	sensitive	1	adjective	
sensitivité	sensitivity	1	noun	
sensør	sensor	1	noun	
sent	scent	1	noun	
sentimint	sentiment	1	noun	
sentins	sentence	3	noun	
sentør	center	2	noun	
sentrul	central	2	adjective	
sentshøré	century	5	noun	
sepirát	separate	3	verb	
sepirit	separate	3	adjective	
sepøráshin	separation	5	noun	
serumóné	ceremony	4	noun	
seshin	session	2	noun	
set	set	0	noun	
seting	setting	1	noun	
setul	settle	2	verb	
setulmint	settlement	3	noun	
sevér	severe	2	adjective	
sevin	seven	1	numeral	
sevinth	seventh	1	numeral	
sevørul	several	2	determiner	
séd	seed	2	noun	
sé	sea	2	noun	
sé	see	2	verb	
sék	seek	2	verb	
sékrit	secret	3	adjective	
sékúins	sequence	6	noun	
sél	seal	2	noun	
séling	ceiling	3	noun	
sém	seem	2	verb	
séminglé	seemingly	3	adverb	
sénéør	senior	3	adjective	
sén	scene	3	noun	
sés	cease	4	verb	
sét	seat	2	noun	
séz	seize	3	verb	
sézin	season	4	noun	
sfér	sphere	4	noun	
shadó	shadow	2	noun	
shal	shall	1	verb	
shaló	shallow	3	adjective	
shaúør	shower	3	noun	
shaút	shout	2	verb	
shád	shade	2	noun	
shák	shake	2	verb	
shám	shame	2	noun	
sháp	shape	2	noun	
shed	shed	0	verb	
shef	chef	1	noun	
shelf	shelf	0	noun	
shel	shell	1	noun	
sheltør	shelter	1	noun	
sherd	shared	2	adjective	
sher	share	2	noun	
sherhóldør	shareholder	4	noun	
shé	she	1	pronoun	
shép	sheep	2	noun	
shér	sheer	2	adjective	
shét	sheet	2	noun	
shift	shift	0	noun	
ship	ship	0	noun	
shit	shit	0	noun	
shí	shy	1	adjective	
shín	shine	2	verb	
shok	shock	1	noun	
shop	shop	0	noun	
shoping	shopping	1	noun	
shork	shark	1	noun	
shorp	sharp	1	adjective	
shorplé	sharply	2	adverb	
shot	shot	0	noun	
shó	show	2	noun	
shóldør	shoulder	3	noun	
shór	shore	2	noun	
shórt-tørm	short-term	2	adjective	
shórt	short	1	adverb	
shórtidzh	shortage	5	noun	
shórtlé	shortly	2	adverb	
shórts	shorts	1	noun	
shød	should	3	verb	
shøgør	sugar	3	noun	
shør	sure	3	adverb	
shørlé	surely	4	adverb	
shørt	shirt	1	noun	
shrimp	shrimp	0	noun	
shrink	shrink	0	verb	
shrug	shrug	0	verb	
shut	shut	0	verb	
shutul	shuttle	2	noun	
shuv	shove	2	verb	
shú	shoe	2	noun	
shút	shoot	2	verb	
shúting	shooting	2	noun	
sibling	sibling	0	noun	
signifikins	significance	4	noun	
signifikint	significant	2	adjective	
signifikintlé	significantly	3	adverb	
signitshør	signature	5	noun	
signul	signal	1	noun	
sigøret	cigarette	4	noun	
sik	sick	1	adjective	
siks	six	2	numeral	
siksth	sixth	2	numeral	
silebrité	celebrity	3	noun	
silekshin	selection	5	noun	
silekt	select	2	verb	
silé	silly	2	adjective	
silk	silk	0	noun	
silvør	silver	1	noun	
simbolik	symbolic	2	adjective	
simbul	symbol	2	noun	
similerité	similarity	2	noun	
similør	similar	1	adjective	
similørlé	similarly	2	adverb	
simpithé	sympathy	3	noun	
simplé	simply	1	adverb	
simptum	symptom	2	noun	
simpul	simple	2	adjective	
sindróm	syndrome	3	noun	
sineréó	scenario	5	noun	
sing	sing	0	verb	
singør	singer	1	noun	
sin	sin	0	noun	
singgul	single	2	adjective	
sink	sink	0	noun	
sins	since	2	adverb	
siréis	serious	4	adjective	
siréislé	seriously	5	adverb	
siréz	series	4	noun	
sistør	sister	1	noun	
sistum	system	2	noun	
sité	city	2	noun	
sit	sit	0	verb	
sitizin	citizen	2	noun	
sitizinship	citizenship	2	noun	
sitshúáshin	situation	7	noun	
sivérlé	severely	4	adverb	
sivik	civic	2	adjective	
siviléin	civilian	3	adjective	
sivilizáshin	civilization	5	noun	
sivul	civil	2	adjective	
síd	side	2	noun	
sídúok	sidewalk	5	noun	
sí	sigh	3	verb	
síins	science	4	noun	
síintifik	scientific	3	adjective	
síintist	scientist	2	noun	
síkolidzhé	psychology	9	noun	
síkolidzhist	psychologist	8	noun	
síkul	cycle	5	noun	
síkulodzhikul	psychological	10	adjective	
sílins	silence	4	noun	
sílint	silent	2	adjective	
símultánéøslé	simultaneously	6	adverb	
sín	sign	2	noun	
sít	sight	3	noun	
sít	site	2	noun	
sít	cite	3	verb	
síz	size	2	noun	
skandul	scandal	2	noun	
skan	scan	1	verb	
skatør	scatter	3	verb	
skál	scale	3	noun	
skárd	scared	3	adjective	
skedzhul	schedule	5	noun	
skeré	scary	3	adjective	
sker	scare	3	verb	
ské	ski	1	noun	
ském	scheme	4	noun	
skild	skilled	2	adjective	
skil	skill	1	noun	
skin	skin	0	noun	
skip	skip	0	verb	
skí	sky	1	noun	
skolør	scholar	3	noun	
skolørship	scholarship	3	noun	
skóp	scope	3	noun	
skór	score	3	noun	
skørt	skirt	1	noun	
skrambul	scramble	3	verb	
skratsh	scratch	2	verb	
skrém	scream	3	verb	
skrén	screen	3	noun	
skréning	screening	3	noun	
skript	script	1	noun	
skrú	screw	3	verb	
skul	skull	1	noun	
skulptshør	sculpture	5	noun	
skúer	square	4	adjective	
skúéz	squeeze	5	verb	
skúl	school	4	noun	
skúod	squad	3	noun	
slam	slam	0	verb	
slap	slap	0	verb	
sláv	slave	2	noun	
slávøré	slavery	3	noun	
slép	sleep	2	noun	
slév	sleeve	3	noun	
slip	slip	0	verb	
slíd	slide	2	noun	
slís	slice	3	noun	
slít	slight	3	adjective	
slítlé	slightly	4	adverb	
slot	slot	0	noun	
sló	slow	2	adjective	
slólé	slowly	3	adverb	
slóp	slope	2	noun	
smel	smell	1	noun	
smíl	smile	2	noun	
smol	small	2	adjective	
smort	smart	1	adjective	
smók	smoke	2	noun	
smúdh	smooth	3	adjective	
snap	snap	0	verb	
snák	snake	2	noun	
snék	sneak	2	verb	
snó	snow	2	noun	
sofin	soften	2	verb	
soft	soft	0	adjective	
softlé	softly	1	adverb	
softúer	software	3	noun	
sok	sock	1	noun	
sokør	soccer	3	noun	
solid	solid	0	adjective	
solt	salt	1	noun	
solv	solve	1	verb	
song	song	0	noun	
soré	sorry	2	adjective	
sos	sauce	4	noun	
sovrinté	sovereignty	4	noun	
só-kold	so-called	5	adjective	
sódéim	sodium	3	noun	
sófu	sofa	2	noun	
só	so	1	adverb	
sóil	soil	1	noun	
sók	soak	2	verb	
sóldzhør	soldier	4	noun	
sól	sole	2	adjective	
sól	soul	2	noun	
sóllé	solely	3	adverb	
sólør	solar	2	adjective	
sóp	soap	2	noun	
sórd	sword	2	noun	
sór	soar	2	verb	
sórs	source	4	noun	
sórt	sort	1	noun	
sóshulé	socially	6	adverb	
sóshul	social	4	adjective	
Sóvéit	Soviet	3	adjective	
søraúnd	surround	4	verb	
søraúnding	surrounding	4	adjective	
sørdzhin	surgeon	5	noun	
sørdzhøré	surgery	6	noun	
sørfis	surface	4	noun	
sør	sir	1	noun	
sørkit	circuit	4	noun	
sørkul	circle	5	noun	
sørkumstans	circumstance	5	noun	
sørtin	certain	3	adjective	
sørtinlé	certainly	4	adverb	
sørtsh	search	4	noun	
sørvá	survey	3	noun	
sørválins	surveillance	7	noun	
sørv	serve	2	verb	
sørving	serving	1	noun	
sørvint	servant	2	noun	
sørvis	service	3	noun	
sørvív	survive	3	verb	
sørvívør	survivor	3	noun	
sørvívul	survival	3	noun	
Spanish	Spanish	0	adjective	
spaús	spouse	3	noun	
spár	spare	2	verb	
spás	space	3	noun	
spekéøláshin	speculation	7	noun	
spekéølát	speculate	5	verb	
spektakéølør	spectacular	5	adjective	
spektrum	spectrum	1	noun	
spel	spell	1	verb	
spend	spend	0	verb	
spending	spending	0	noun	
speshul	special	3	adjective	
speshulist	specialist	3	noun	
speshulíz	specialize	5	verb	
speshulté	specialty	4	noun	
spesifik	specific	2	adjective	
spesifiklé	specifically	5	adverb	
spesifí	specify	2	verb	
spéd	speed	2	noun	
spék	speak	2	verb	
spékør	speaker	3	noun	
spéshéz	species	5	noun	
spétsh	speech	3	noun	
spil	spill	1	verb	
spin	spin	0	verb	
spirit	spirit	0	noun	
spiritshúul	spiritual	4	adjective	
spit	spit	0	verb	
spí	spy	1	noun	
spín	spine	2	noun	
spít	spite	2	preposition	
split	split	0	verb	
sponsør	sponsor	1	noun	
spork	spark	1	verb	
spot	spot	0	noun	
spóksmin	spokesman	3	noun	
spórt	sport	1	noun	
sprá	spray	2	noun	
spred	spread	1	noun	
spring	spring	0	noun	
sprinkul	sprinkle	2	verb	
spún	spoon	2	noun	
stadéum	stadium	1	noun	
staf	staff	1	noun	
stak	stack	1	noun	
stand	stand	0	noun	
standing	standing	0	noun	
standørd	standard	1	adjective	
stans	stance	2	noun	
statis	status	1	noun	
statshéú	statue	4	noun	
statshéút	statute	5	noun	
stábul	stable	3	adjective	
stádzh	stage	4	noun	
stá	stay	2	noun	
sták	stake	2	noun	
sták	steak	2	noun	
stár	stare	2	verb	
stáshin	station	4	noun	
stát	state	2	noun	
státmint	statement	3	noun	
stedé	steady	2	adjective	
stedilé	steadily	2	adverb	
stem	stem	0	noun	
step	step	0	noun	
steréótíp	stereotype	4	noun	
ster	stair	2	noun	
stél	steal	2	verb	
stél	steel	2	noun	
stém	steam	2	noun	
stép	steep	2	adjective	
stér	steer	2	verb	
stif	stiff	1	adjective	
stik	stick	1	noun	
stil	still	1	adverb	
stiméølát	stimulate	4	verb	
stiméølis	stimulus	3	noun	
stíl	style	2	noun	
stok	stock	1	noun	
stop	stop	0	noun	
stor	star	1	noun	
stort	start	1	noun	
storting	starting	1	noun	
stortør	starter	2	noun	
stón	stone	2	noun	
stóré	story	2	noun	
stór	store	2	noun	
stóridzh	storage	5	noun	
stórm	storm	1	noun	
stóv	stove	2	noun	
stør	stir	1	verb	
stratidzhé	strategy	5	noun	
strándzh	strange	4	adjective	
strándzhør	stranger	5	noun	
strán	strain	2	noun	
strát	straight	4	adverb	
strátin	straighten	5	verb	
strength	strength	0	noun	
strengthin	strengthen	1	verb	
stres	stress	1	noun	
stretsh	stretch	1	noun	
strék	streak	2	noun	
strém	stream	2	noun	
strét	street	2	noun	
strikt	strict	1	adjective	
striktlé	strictly	2	adverb	
string	string	0	noun	
strip	strip	0	noun	
strík	strike	2	noun	
stríking	striking	1	adjective	
stro	straw	2	noun	
strong	strong	0	adjective	
stronglé	strongly	1	adverb	
strók	stroke	2	noun	
strugul	struggle	2	noun	
strukshør	structure	5	noun	
strukshørul	structural	5	adjective	
strutédzhik	strategic	6	adjective	
stubilité	stability	2	noun	
studé	study	1	noun	
stuf	stuff	1	noun	
stumbul	stumble	2	verb	
stumik	stomach	4	noun	
stutistiks	statistics	2	noun	
stutistikul	statistical	3	adjective	
stúdéó	studio	3	noun	
stúdint	student	2	noun	
stúpid	stupid	1	adjective	
subdzhekt	subject	4	noun	
submit	submit	0	verb	
subørb	suburb	1	noun	
subørbin	suburban	2	adjective	
subsidé	subsidy	1	noun	
subsikúint	subsequent	4	adjective	
substanshulé	substantially	5	adverb	
substanshul	substantial	3	adjective	
substins	substance	3	noun	
sudhørn	southern	3	adjective	
sudin	sudden	2	adverb	
sudinlé	suddenly	3	adverb	
sufishint	sufficient	4	adjective	
sufistikátid	sophisticated	6	adjective	
sufør	suffer	2	verb	
suføring	suffering	2	noun	
sugdzhest	suggest	3	verb	
sugdzhestshin	suggestion	6	noun	
suk	suck	1	verb	
suksesfulé	successfully	5	adverb	
suksesful	successful	3	adjective	
sukses	success	3	noun	
sukséd	succeed	4	verb	
sulektid	selected	3	adjective	
sulúshin	solution	5	noun	
sumbudé	somebody	4	pronoun	
sumdá	someday	4	adverb	
sum	some	2	determiner	
sum	sum	0	noun	
sumhaú	somehow	4	adverb	
sumit	summit	1	noun	
sumøré	summary	3	noun	
sumør	summer	2	noun	
sumthing	something	2	pronoun	
sumtím	sometime	4	adverb	
sumtímz	sometimes	5	adverb	
sumúer	somewhere	5	adverb	
sumúun	someone	4	pronoun	
sumúut	somewhat	5	adverb	
Sundá	Sunday	2	noun	
suné	sunny	2	adjective	
sun	son	1	noun	
sun	sun	0	noun	
sunlít	sunlight	3	noun	
suplí	supply	2	noun	
suplíør	supplier	3	noun	
supórt	support	2	noun	
supórtiv	supportive	3	adjective	
supórtør	supporter	3	noun	
supózd	supposed	4	adjective	
supóz	suppose	4	verb	
supózidlé	supposedly	5	adverb	
suprízd	surprised	4	adjective	
supríz	surprise	4	noun	
suprízing	surprising	3	adjective	
suprízinglé	surprisingly	4	adverb	
susíité	society	5	noun	
suspekt	suspect	1	noun	
suspend	suspend	0	verb	
suspishin	suspicion	3	noun	
suspishis	suspicious	4	adjective	
sustán	sustain	2	verb	
sustánibul	sustainable	5	adjective	
sutsh	such	2	preposition	
sutul	subtle	3	adjective	
súel	swell	2	verb	
súer	swear	2	verb	
súet	sweat	2	noun	
súetør	sweater	3	noun	
súép	sweep	3	verb	
súét	suite	3	noun	
súét	sweet	3	adjective	
sú	sue	2	verb	
súim	swim	1	verb	
súiming	swimming	2	noun	
súing	swing	1	noun	
súisíd	suicide	4	noun	
súitsh	switch	2	noun	
sún	soon	2	adverb	
súoló	swallow	5	verb	
súpéréør	superior	4	adjective	
súp	soup	2	noun	
súpør	super	2	adjective	
súpørmorkit	supermarket	4	noun	
súpørvízør	supervisor	5	noun	
súprém	Supreme	4	adjective	
sút	suit	2	noun	
sútibul	suitable	5	adjective	
T-shørt	T-shirt	1	noun	
tag	tag	0	noun	
taks	tax	2	noun	
takspáør	taxpayer	5	noun	
taktik	tactic	2	noun	
takul	tackle	3	verb	
talentid	talented	1	adjective	
talint	talent	1	noun	
tap	tap	0	verb	
task	task	0	noun	
taúl	towel	3	noun	
taún	town	2	noun	
taúør	tower	3	noun	
tábul	table	3	noun	
tábulspún	tablespoon	5	noun	
ták	take	2	verb	
tál	tail	2	noun	
tál	tale	2	noun	
tánk	tank	1	noun	
táp	tape	2	noun	
tást	taste	2	noun	
teknék	technique	6	noun	
teknikul	technical	4	adjective	
teknilodzhikul	technological	8	adjective	
teknishin	technician	5	noun	
teknolidzhé	technology	7	noun	
tekstbøk	textbook	4	noun	
tekst	text	2	noun	
tekstshør	texture	6	noun	
telefón	telephone	4	noun	
teleskóp	telescope	3	noun	
televizhin	television	3	noun	
tel	tell	1	verb	
tempøreré	temporary	3	adjective	
tempritshør	temperature	6	noun	
tempul	temple	2	noun	
tend	tend	0	verb	
tendinsé	tendency	3	noun	
tendør	tender	1	adjective	
ten	ten	0	numeral	
tenis	tennis	1	noun	
tenshin	tension	2	noun	
tent	tent	0	noun	
ter	tear	1	noun	
teriblé	terribly	2	adverb	
teribul	terrible	3	adjective	
teritóré	territory	3	noun	
terør	terror	2	noun	
terørism	terrorism	2	noun	
terørist	terrorist	2	adjective	
test	test	0	noun	
testifí	testify	1	verb	
testimóné	testimony	2	noun	
testing	testing	0	noun	
té	tea	2	noun	
tém	team	2	noun	
témmát	teammate	4	noun	
ténádzh	teenage	6	adjective	
ténádzhør	teenager	7	noun	
tén	teen	2	noun	
téspún	teaspoon	4	noun	
tétsh	teach	3	verb	
tétshing	teaching	3	noun	
tétshør	teacher	4	noun	
thank	thank	0	verb	
Thanksgiving	Thanksgiving	0	noun	
thanks	thanks	0	noun	
thaúzind	thousand	4	numeral	
theripé	therapy	2	noun	
theripist	therapist	1	noun	
théilodzhikul	theological	7	adjective	
théiretikul	theoretical	4	adjective	
théitør	theater	3	noun	
thém	theme	2	noun	
théolidzhé	theology	6	noun	
thik	thick	1	adjective	
thing	thing	0	noun	
thin	thin	0	adjective	
think	think	0	verb	
thinking	thinking	0	noun	
thiré	theory	3	noun	
thí	thigh	3	noun	
thot	thought	3	noun	
thørd	third	1	numeral	
thøró	thorough	5	adjective	
thørté	thirty	2	numeral	
thørulé	thoroughly	5	adverb	
Thørzdá	Thursday	4	noun	
thred	thread	1	noun	
threshhóld	threshold	2	noun	
thret	threat	1	noun	
thretin	threaten	2	verb	
thré	three	2	numeral	
thrív	thrive	2	verb	
thró	throw	2	verb	
thrót	throat	2	noun	
thrúaút	throughout	6	preposition	
thrú	through	4	adverb	
thum	thumb	1	noun	
tikit	ticket	2	noun	
til	till	1	preposition	
timbør	timber	1	noun	
tip	tip	0	noun	
tipiklé	typically	5	adverb	
tipikul	typical	3	adjective	
tishéú	tissue	3	noun	
tíd	tide	2	noun	
tí	tie	2	noun	
tíl	tile	2	noun	
tím	time	2	noun	
tíming	timing	1	noun	
tíné	tiny	2	adjective	
típ	type	2	noun	
tírd	tired	2	adjective	
tír	tire	2	verb	
tít	tight	3	adverb	
títin	tighten	4	verb	
títlé	tightly	4	adverb	
títul	title	3	noun	
tok	talk	2	noun	
toksik	toxic	3	adjective	
tol	tall	2	adjective	
tolørát	tolerate	3	verb	
tolørins	tolerance	4	noun	
top	top	0	adjective	
topik	topic	1	noun	
torgit	target	2	noun	
tos	toss	1	verb	
tó	toe	2	noun	
tói	toy	2	noun	
tóilit	toilet	2	noun	
tól	toll	2	noun	
tón	tone	2	noun	
tótulé	totally	4	adverb	
tótul	total	2	adjective	
tørán	terrain	4	noun	
tørifik	terrific	3	adjective	
tørké	turkey	3	noun	
tørm	term	1	noun	
tørmz	terms	2	preposition	
tørn	turn	1	noun	
tørnimint	tournament	4	noun	
tradzhidé	tragedy	5	noun	
tradzhik	tragic	4	adjective	
trafik	traffic	2	noun	
trak	track	1	noun	
transakshin	transaction	4	noun	
transfórm	transform	1	verb	
transfør	transfer	1	noun	
transførmáshin	transformation	5	noun	
transishin	transition	3	noun	
transit	transit	0	noun	
transláshin	translation	4	noun	
translát	translate	2	verb	
transmishin	transmission	2	noun	
transmit	transmit	0	verb	
transpórt	transport	1	noun	
transpørtáshin	transportation	5	noun	
trap	trap	0	noun	
trash	trash	0	noun	
travilør	traveler	2	noun	
travul	travel	1	noun	
trád	trade	2	noun	
tráding	trading	1	noun	
trá	tray	2	noun	
trál	trail	2	noun	
trálør	trailer	3	noun	
trán	train	2	noun	
tráning	training	2	noun	
tránør	trainer	3	noun	
trás	trace	3	noun	
trát	trait	2	noun	
trend	trend	0	noun	
trezhør	treasure	4	noun	
tré	tree	2	noun	
trété	treaty	3	noun	
trét	treat	2	verb	
trétmint	treatment	3	noun	
trigør	trigger	2	verb	
trik	trick	1	noun	
trimendis	tremendous	3	adjective	
trim	trim	0	verb	
trip	trip	0	noun	
tríb	tribe	2	noun	
tríbul	tribal	2	adjective	
trí	try	1	verb	
tríul	trial	2	noun	
tríumf	triumph	3	noun	
tromu	trauma	3	noun	
tropikul	tropical	2	adjective	
trubuld	troubled	3	adjective	
trubul	trouble	3	noun	
trudishin	tradition	4	noun	
trudishinulé	traditionally	7	adverb	
trudishinul	traditional	5	adjective	
truk	truck	1	noun	
trunk	trunk	0	noun	
trust	trust	0	noun	
trú	true	2	adjective	
trúlé	truly	2	adverb	
trúp	troop	2	noun	
trúth	truth	1	noun	
tshalindzh	challenge	7	noun	
tshampéin	champion	4	noun	
tshampéinship	championship	4	noun	
tshans	chance	4	noun	
tshanul	channel	4	noun	
tshaptør	chapter	3	noun	
tshámbør	chamber	4	noun	
tshándzh	change	6	noun	
tshándzhing	changing	6	adjective	
tshán	chain	4	noun	
tshás	chase	4	verb	
tshek	check	3	noun	
tshEO	CEO	3	noun	
tsher	chair	4	noun	
tsherité	charity	4	noun	
tshermin	chairman	5	noun	
tshest	chest	2	noun	
tshéf	chief	4	adjective	
tshék	cheek	4	noun	
tshép	cheap	4	adjective	
tshér	cheer	4	verb	
tshét	cheat	4	verb	
tshéz	cheese	6	noun	
tshikin	chicken	4	noun	
tshil	chill	3	noun	
tshin	chin	2	noun	
tship	chip	2	noun	
tshíld	child	3	noun	
tshíldhød	childhood	5	noun	
tshínéz	Chinese	6	adjective	
tshoklit	chocolate	6	noun	
tshop	chop	2	verb	
tshordzh	charge	6	noun	
tshorm	charm	3	noun	
tshort	chart	3	noun	
tshortør	charter	4	noun	
tshóis	choice	5	noun	
tshørtsh	church	5	noun	
tshunk	chunk	2	noun	
tshú	chew	4	verb	
tshúz	choose	6	verb	
tubakó	tobacco	4	noun	
tudá	today	3	adverb	
tuf	tough	3	adjective	
tugedhør	together	3	adverb	
tuk	tuck	1	verb	
tumátó	tomato	3	noun	
tumoró	tomorrow	4	adverb	
tumotó	tomato	3	noun	
tung	tongue	3	noun	
tunít	tonight	4	adverb	
tunul	tunnel	2	noun	
tutshdaún	touchdown	5	noun	
tutsh	touch	3	noun	
tú-thørdz	two-thirds	4	numeral	
túb	tube	2	noun	
túelv	twelve	2	numeral	
túenté	twenty	2	numeral	
túentéith	twentieth	3	numeral	
tú	to	1	preposition	
tú	too	2	adverb	
tú	two	2	numeral	
túin	twin	1	noun	
túist	twist	1	noun	
túís	twice	4	adverb	
túl	tool	2	noun	
túmør	tumor	2	noun	
tún	tune	2	noun	
túórd	toward	3	preposition	
túórdz	towards	4	preposition	
túr	tour	2	noun	
túrism	tourism	2	noun	
túrist	tourist	2	noun	
túth	tooth	2	noun	
Túzdá	Tuesday	5	noun	
TV	TV	0	noun	
ubandin	abandon	2	verb	
ubaút	about	3	adverb	
ubdzhekshin	objection	8	noun	
ubdzhekt	object	5	noun	
ubdzhektiv	objective	6	noun	
ubéús	abuse	4	noun	
ubilité	ability	2	noun	
ubrod	abroad	2	adverb	
ubtán	obtain	3	verb	
ubuv	above	3	adverb	
ubzórb	absorb	3	verb	
ubzørv	observe	4	verb	
ubzørvør	observer	4	noun	
udapt	adapt	1	verb	
udhør	other	3	adjective	
udhørúíz	otherwise	7	adverb	
udhørz	others	4	noun	
udishin	addition	5	noun	
udishinul	additional	6	adjective	
udopshin	adoption	4	noun	
udopt	adopt	1	verb	
udres	address	3	noun	
udult	adult	1	noun	
udzhendu	agenda	5	noun	
udzhust	adjust	3	verb	
udzhustmint	adjustment	4	noun	
ufár	affair	4	noun	
ufekt	affect	3	verb	
ufendør	offender	3	noun	
ufens	offense	3	noun	
ufensiv	offensive	3	adjective	
ufishulé	officially	7	adverb	
ufishul	official	5	adjective	
ufórd	afford	3	verb	
ufrád	afraid	3	adjective	
u	a	1	article	
ugen	again	3	adverb	
ugenst	against	3	preposition	
uglé	ugly	1	adjective	
ugó	ago	2	adverb	
ugreshin	aggression	4	noun	
ugresiv	aggressive	4	adjective	
ugré	agree	3	verb	
ugrémint	agreement	4	noun	
u	uh	1	interjection	
uhed	ahead	2	adverb	
ukaúnt	account	5	noun	
ukaúntibilité	accountability	7	noun	
ukaúnting	accounting	5	noun	
ukázhin	occasion	6	noun	
ukázhinulé	occasionally	9	adverb	
ukázhinul	occasional	7	adjective	
ukéuz	accuse	5	verb	
ukomidát	accommodate	7	verb	
ukomplish	accomplish	3	verb	
ukomplishmint	accomplishment	4	noun	
ukórding	according	4	preposition	
ukør	occur	4	verb	
ukros	across	3	adverb	
ukumpiné	accompany	6	verb	
ukúír	acquire	6	verb	
ulabørát	elaborate	4	adjective	
ulaú	allow	4	verb	
uledzhid	alleged	6	adjective	
uledzhidlé	allegedly	7	adverb	
ulekshin	election	5	noun	
ulekt	elect	2	verb	
ulektrik	electric	3	adjective	
ulektrikul	electrical	4	adjective	
ulektrisité	electricity	4	noun	
ulektronik	electronic	3	adjective	
ulektroniks	electronics	3	noun	
ulevin	eleven	2	numeral	
uliminát	eliminate	3	verb	
Ulimpik	Olympic	3	adjective	
Ulimpiks	Olympics	3	noun	
ulíins	alliance	5	noun	
ulík	alike	3	adverb	
ulív	alive	3	adjective	
ulong	along	1	adverb	
ulongsíd	alongside	3	preposition	
ulorm	alarm	2	noun	
ulón	alone	3	adverb	
ultimit	ultimate	2	adjective	
ultimitlé	ultimately	3	adverb	
ulúminum	aluminum	2	noun	
umaúnt	amount	3	noun	
umázing	amazing	2	adjective	
umendmint	amendment	2	noun	
umid	amid	1	preposition	
umung	among	2	preposition	
unalisis	analysis	2	noun	
unaúns	announce	6	verb	
unaúnsmint	announcement	7	noun	
unábul	unable	3	adjective	
undørgó	undergo	2	verb	
undørgradzhúit	undergraduate	6	noun	
undør	under	1	adverb	
undørlíing	underlying	2	adjective	
undørmín	undermine	3	verb	
undørstand	understand	1	verb	
undørstanding	understanding	1	noun	
undørták	undertake	3	verb	
unekspektid	unexpected	4	adjective	
unemplóimint	unemployment	3	noun	
unéin	onion	3	noun	
unéúzhúul	unusual	6	adjective	
unfár	unfair	2	adjective	
unfóld	unfold	1	verb	
unfórtshinitlé	unfortunately	7	adverb	
unhapé	unhappy	2	adjective	
unkul	uncle	3	noun	
unkumftørbul	uncomfortable	8	adjective	
unkuvør	uncover	3	verb	
unles	unless	1	conjunction	
unlík	unlike	2	adjective	
unlíklé	unlikely	3	adjective	
unnón	unknown	3	adjective	
unonimis	anonymous	4	adjective	
unpresidentid	unprecedented	3	adjective	
unsørtin	uncertain	3	adjective	
unsørtinté	uncertainty	4	noun	
until	until	0	preposition	
unudhør	another	4	pronoun	
updát	update	2	verb	
uperint	apparent	4	adjective	
uperintlé	apparently	5	adverb	
upél	appeal	4	noun	
upér	appear	4	verb	
upérins	appearance	7	noun	
up	up	0	adverb	
upinéin	opinion	3	noun	
uplí	apply	3	verb	
upolidzhé	apology	6	noun	
upolidzhíz	apologize	7	verb	
upon	upon	0	preposition	
uport	apart	2	adverb	
uportmint	apartment	3	noun	
upóint	appoint	3	verb	
upóintmint	appointment	4	noun	
upónint	opponent	4	noun	
upózd	opposed	5	preposition	
upóz	oppose	5	verb	
upør	upper	2	adjective	
upréshéáshin	appreciation	10	noun	
upréshéát	appreciate	8	verb	
uproksimitlé	approximately	7	adverb	
uprópréit	appropriate	6	adjective	
uprótsh	approach	5	noun	
uprúv	approve	4	verb	
uprúvul	approval	4	noun	
upset	upset	0	adjective	
upsterz	upstairs	3	adverb	
uraúnd	around	3	adverb	
urá	array	4	noun	
urándzh	arrange	6	verb	
urándzhmint	arrangement	7	noun	
urest	arrest	2	noun	
urénu	arena	3	noun	
uridzhinulé	originally	7	adverb	
uridzhinul	original	5	adjective	
urív	arrive	4	verb	
urívul	arrival	4	noun	
uríz	arise	4	verb	
usemblé	assembly	3	noun	
usembul	assemble	4	verb	
uses	assess	3	verb	
usesmint	assessment	4	noun	
us	us	0	pronoun	
ushúr	assure	4	verb	
usist	assist	2	verb	
usistins	assistance	5	noun	
usistint	assistant	3	adjective	
usíd	aside	3	adverb	
usín	assign	4	verb	
usínmint	assignment	5	noun	
uslép	asleep	3	adjective	
usolt	assault	4	noun	
usóshéáshin	association	8	noun	
usóshéátid	associated	7	adjective	
usóshéit	associate	6	noun	
usørt	assert	3	verb	
ustronimør	astronomer	3	noun	
usumpshin	assumption	5	noun	
usúm	assume	4	verb	
utak	attack	3	noun	
utatsh	attach	4	verb	
utempt	attempt	2	noun	
utend	attend	2	verb	
utendins	attendance	5	noun	
utenshin	attention	5	noun	
uthórité	authority	3	noun	
utonimé	autonomy	3	noun	
utop	atop	1	preposition	
utørné	attorney	5	noun	
utrakshin	attraction	6	noun	
utrakt	attract	3	verb	
utraktiv	attractive	4	adjective	
utribéút	attribute	5	verb	
utshév	achieve	6	verb	
utshévmint	achievement	7	noun	
uúá	away	4	adverb	
uúák	awake	4	adjective	
uúát	await	4	verb	
uúer	aware	4	adjective	
uúernis	awareness	6	noun	
uúórd	award	3	noun	
uválibilité	availability	5	noun	
uválibul	available	6	adjective	
uv	of	2	preposition	
uvin	oven	2	noun	
uvóid	avoid	2	verb	
u'klok	o'clock	3	adverb	
úagin	wagon	2	noun	
úaú	wow	3	interjection	
úádzh	wage	5	noun	
úá	way	3	adverb	
úá	weigh	5	verb	
úák	wake	3	noun	
úál	whale	4	noun	
úást	waist	3	noun	
úást	waste	3	noun	
úát	wait	3	verb	
úát	weight	5	noun	
úáv	wave	3	noun	
úeb	web	1	noun	
úedhør	weather	4	noun	
úedhør	whether	4	conjunction	
úeding	wedding	2	noun	
úel-béing	well-being	3	noun	
úel-nón	well-known	5	adjective	
úelfár	welfare	3	noun	
úel	well	2	adverb	
úelkum	welcome	4	adjective	
úelthé	wealthy	3	adjective	
úelth	wealth	2	noun	
úenevør	whenever	3	adverb	
úen	when	2	adverb	
Úenzdá	Wednesday	6	noun	
úepin	weapon	3	noun	
úeraz	whereas	4	conjunction	
úerevør	wherever	3	adverb	
úer	wear	2	verb	
úer	where	3	adverb	
úerhaús	warehouse	6	noun	
úest	west	1	noun	
úestørn	western	2	adjective	
úet	wet	1	adjective	
úéd	weed	3	noun	
úé	we	2	pronoun	
úékend	weekend	3	noun	
úék	weak	3	adjective	
úék	week	3	noun	
úékin	weaken	4	verb	
úéklé	weekly	4	adjective	
úéknis	weakness	5	noun	
úél	wheel	4	noun	
úéltshár	wheelchair	8	noun	
úérd	weird	3	adjective	
úét	wheat	4	noun	
úév	weave	4	verb	
úidó	widow	3	noun	
úildørnis	wilderness	4	noun	
úil	will	2	noun	
úiling	willing	2	adjective	
úilingnis	willingness	4	noun	
úind	wind	1	noun	
úindó	window	3	noun	
úing	wing	1	noun	
úin	win	1	noun	
úinør	winner	3	noun	
úintør	winter	2	noun	
úip	whip	2	verb	
úisdum	wisdom	2	noun	
úish	wish	1	noun	
úispør	whisper	3	verb	
úithaút	without	3	preposition	
úithdro	withdraw	3	verb	
úithdrol	withdrawal	4	noun	
úith	with	1	preposition	
úithin	within	1	adverb	
úitnis	witness	3	noun	
úitsh	which	4	determiner	
úíd	wide	3	adjective	
úídlé	widely	4	adverb	
úídspred	widespread	4	adjective	
úíf	wife	3	noun	
úí	why	3	adverb	
úíld	wild	2	adjective	
úíldlíf	wildlife	4	noun	
úíl	while	4	noun	
úín	wine	3	noun	
úíp	wipe	3	verb	
úír	wire	3	noun	
úít	white	4	adjective	
úíz	wise	4	adjective	
úok	walk	3	noun	
úoking	walking	3	noun	
úol	wall	3	noun	
úondør	wander	3	verb	
úont	want	2	verb	
úosh	wash	2	verb	
úotør	water	3	noun	
úotsh	watch	3	noun	
úóréør	warrior	5	noun	
úór	war	2	noun	
úórm	warm	2	adjective	
úórmth	warmth	2	noun	
úórn	warn	2	verb	
úórning	warning	2	noun	
úød	wood	3	noun	
úød	would	4	verb	
úødin	wooden	4	adjective	
úømin	woman	3	noun	
úørd	word	2	noun	
úøréd	worried	5	adjective	
úøré	worry	4	noun	
úørkaút	workout	4	noun	
úørk	work	2	noun	
úørking	working	2	adjective	
úørkør	worker	3	noun	
úørkplás	workplace	5	noun	
úørks	works	2	noun	
úørkshop	workshop	2	noun	
úørld	world	2	noun	
úørldúíd	worldwide	5	adverb	
úørth	worth	2	noun	
úøúnd	wound	3	noun	
úulf	wolf	2	noun	
úun-thørd	one-third	4	numeral	
úundørful	wonderful	3	adjective	
úundør	wonder	3	noun	
úun	one	3	noun	
úuns	once	4	adverb	
úutevør	whatever	4	determiner	
úut	what	3	determiner	
vakéúm	vacuum	3	noun	
vaksén	vaccine	4	noun	
valé	valley	3	noun	
valéibul	valuable	4	adjective	
valéú	value	2	noun	
valid	valid	0	adjective	
van	van	0	noun	
vanish	vanish	0	verb	
vast	vast	0	adjective	
vákáshin	vacation	6	noun	
vedzhtibul	vegetable	6	noun	
vendør	vendor	1	noun	
ventshør	venture	4	noun	
veréáshin	variation	6	noun	
veré	vary	2	verb	
veré	very	1	adverb	
veréibul	variable	5	noun	
veréis	various	4	adjective	
vesul	vessel	2	noun	
vetirin	veteran	2	adjective	
véikul	vehicle	5	noun	
véu	via	2	preposition	
véú	view	3	noun	
véúør	viewer	4	noun	
vidéó	video	2	noun	
viktim	victim	1	noun	
viktøré	victory	3	noun	
vilidzh	village	4	noun	
vizhin	vision	3	noun	
vizhúul	visual	4	adjective	
vizibul	visible	3	adjective	
vizit	visit	1	noun	
vizitør	visitor	2	noun	
vílins	violence	5	noun	
vílint	violent	3	adjective	
víris	virus	2	noun	
vítimin	vitamin	2	noun	
vítul	vital	2	adjective	
víuláshin	violation	6	noun	
víulát	violate	4	verb	
voléúm	volume	3	noun	
volinteré	voluntary	3	adjective	
volintér	volunteer	3	noun	
vóis	voice	3	noun	
vókul	vocal	3	adjective	
vót	vote	2	noun	
vóting	voting	1	noun	
vótør	voter	2	noun	
vørbul	verbal	2	adjective	
vørdikt	verdict	2	noun	
vørsis	versus	2	preposition	
vørtikul	vertical	3	adjective	
vørtshú	virtue	4	noun	
vørtshúulé	virtually	6	adverb	
vørtshúul	virtual	5	adjective	
vørzhin	version	4	noun	
vulidité	validity	2	noun	
vulnøribul	vulnerable	4	adjective	
vuríité	variety	4	noun	
zhonru	genre	4	noun	
zón	zone	2	noun	