ai	eye
Ai	I
ailind	island
ail	aisle
airanikly	ironically
Airiš	Irish
airuny	irony
airn	iron
aibräw	eyebrow
aikan	icon
aidentifai	identify
aidentifikeišin	identification
aidentikul	identical
aidentity	identity
aidyalidžy	ideology
aidyuladžikul	ideological
aidyu	idea
aidyl	ideal
aidhør	either
aitum	item
aisuleitid	isolated
aisuleit	isolate
aisuleišin	isolation
ais	ice
a	ah
alweiz	always
al	all
alredy	already
almost	almost
aldho	although
altør	alter
altørnitiv	alternative
altugedhør	altogether
also	also
army	army
arm	arm
armd	armed
argyw	argue
argywmint	argument
arkitekt	architect
arkitekšør	architecture
artifäkt	artifact
artifišul	artificial
artikul	article
artikyøleit	articulate
artistik	artistic
artist	artist
art	art
anør	honor
anistly	honestly
anist	honest
anlain	online
an	on
anvelop	envelope
antw	onto
ant	aunt
antrepenwr	entrepreneur
an-going	ongoing
abligeišin	obligation
abvyis	obvious
abvyisly	obviously
abzørveišin	observation
abstikul	obstacle
apøreitør	operator
apøreiting	operating
apøreit	operate
apøreišin	operation
apørtwnity	opportunity
apuzit	opposite
apuzišin	opposition
apru	opera
aptimistik	optimistic
apt	opt
apšin	option
aføring	offering
afør	offer
afin	often
afisør	officer
afis	office
aful	awful
af	off
akyøpai	occupy
akyøpeišin	occupation
aksidžen	oxygen
akšin	auction
adyins	audience
ad	odd
adz	odds
ato	auto
atumätik	automatic
atumätikly	automatically
atumubyl	automobile
at	ought
athøraiz	authorize
athør	author
äwr	our
äwr	hour
äwrz	ours
äwrselvz	ourselves
äwtør	outer
äwtlain	outline
äwt	out
äwtlit	outlet
äwtpøt	output
äwtfit	outfit
äwtkum	outcome
äwtdor	outdoor
äwtsaidør	outsider
äwtsaid	outside
äwtständing	outstanding
älai	ally
äligeišin	allegation
äly	alley
älbum	album
älkuhal	alcohol
ämbäsidør	ambassador
ämbišin	ambition
ämbišis	ambitious
änimul	animal
änivørsøry	anniversary
änulaiz	analyze
änulist	analyst
änywuly	annually
änywul	annual
änkul	ankle
änd	and
äntisipeit	anticipate
änsestør	ancestor
änsør	answer
äbsins	absence
äbsulwt	absolute
äbsulwtly	absolutely
äbsträkt	abstract
äpul	apple
äplikeišin	application
ävridž	average
äfekt	affect
Äfrikin	African
Äfrikin-Umerikin	African-American
äftørwørd	afterward
äftør	after
äftørnwn	afternoon
ägrikultšørul	agricultural
ägrikultšør	agriculture
äkidemik	academic
äkyørit	accurate
äkyøritly	accurately
äkyørisy	accuracy
äkyøzeišin	accusation
äkwizišin	acquisition
äknalidž	acknowledge
äktør	actor
äktivity	activity
äktivist	activist
äktiv	active
äktivly	actively
äkt	act
äktris	actress
äksent	accent
äkseptibul	acceptable
äksept	accept
äksesibul	accessible
äkses	access
äksidint	accident
äkšin	action
äkšwuly	actually
äkšwul	actual
ädikwit	adequate
ädid	added
ädulesint	adolescent
äd	add
ädres	address
ädmair	admire
ädministør	administer
ädministreitør	administrator
ädministreišin	administration
ädministritiv	administrative
ädmit	admit
ädmišin	admission
ädvaizør	adviser
ädvaiz	advise
ädvais	advice
ädväntidž	advantage
ädväns	advance
ädvänst	advanced
ädventšør	adventure
ädvørtaizing	advertising
ädvukeit	advocate
ädvukit	advocate
äd.	ad
ätitwd	attitude
ät	at
ätribywt	attribute
ätmusfyr	atmosphere
äthletik	athletic
äthlyt	athlete
äz	as
äset	asset
äsid	acid
äs	ass
äspekt	aspect
äsk	ask
ästhetik	aesthetic
äš	ash
eilyin	alien
eir	air
eirlain	airline
eirport	airport
eirplein	airplane
eirkräft	aircraft
eim	aim
einggør	anger
einggul	angle
einggry	angry
eindžul	angel
einšint	ancient
eibul	able
eid	aide
eid	aid
eidžint	agent
eidžinsy	agency
eidž	age
eit	eight
eitth	eighth
Eižin	Asian
elimentøry	elementary
elimint	element
eliveitør	elevator
elifint	elephant
eligint	elegant
elidžibul	eligible
elyt	elite
elbo	elbow
eldør	elder
eldørly	elderly
elswer	elsewhere
els	else
ero	arrow
erør	error
eru	era
eryu	area
emberist	embarrassed
embreis	embrace
empair	empire
emploiør	employer
emploiy	employee
emploi	employ
emploimint	employment
empty	empty
emfisaiz	emphasize
emfisis	emphasis
enäkt	enact
eneibul	enable
enørdžy	energy
enimy	enemy
enywei	anyway
enywer	anywhere
enywun	anyone
eny	any
enymor	anymore
enybudy	anybody
enything	anything
enrol	enroll
envairnmentul	environmental
envairnmint	environment
envelop	envelope
envižin	envision
enfors	enforce
enforsmint	enforcement
enggeidž	engage
enggeidžmint	engagement
engšis	anxious
enkäwntør	encounter
enkøridžing	encouraging
enkøridž	encourage
enksaiety	anxiety
endors	endorse
endør	endure
end	end
endlis	endless
endžoi	enjoy
endžinyring	engineering
endžinyr	engineer
endžin	engine
entair	entire
entairly	entirely
entaitul	entitle
entør	enter
entørpraiz	enterprise
entørteinmint	entertainment
entity	entity
entrens	entrance
entry	entry
enthuzyäzm	enthusiasm
enšør	ensure
enhäns	enhance
epidemik	epidemic
episod	episode
evalv	evolve
evälyweit	evaluate
evälyweišin	evaluation
event	event
eventšwuly	eventually
evør	ever
evilwšin	evolution
evidens	evidence
evidint	evident
evrywer	everywhere
evrywun	everyone
evry	every
evrybudy	everybody
evrydei	everyday
evrything	everything
efektiv	effective
efektivly	effectively
efektivnis	effectiveness
efekt	effect
eført	effort
eg	egg
egzatik	exotic
egzast	exhaust
egzämineišin	examination
egzämin	examine
egzäm	exam
egzämpul	example
egzäkt	exact
egzäktly	exactly
egzekyøtiv	executive
egzekywšin	execution
egzibit	exhibit
egzibišin	exhibition
egzisting	existing
egzistins	existence
egzist	exist
ekanimist	economist
ekanimy	economy
eko	echo
ekiladžikul	ecological
ekinamik	economic
ekinamikly	economically
ekinamiks	economics
ekwip	equip
ekwipmint	equipment
ekwivilint	equivalent
ekwity	equity
eksaiting	exciting
eksaitid	excited
eksaitmint	excitement
ekselireit	accelerate
ekseptins	acceptance
eksept	except
eksepšin	exception
eksekywt	execute
eksesiv	excessive
eksørsaiz	exercise
eksilint	excellent
eksit	exit
eksyd	exceed
ekspänd	expand
ekspänšin	expansion
ekspens	expense
ekspens	expensive
ekspekteišin	expectation
ekspektid	expected
ekspekt	expect
ekspedišin	expedition
eksport	export
ekspoz	expose
ekspožør	exposure
ekspørtyz	expertise
ekspørt	expert
ekspirimentul	experimental
ekspirimint	experiment
ekspiryins	experience
ekspiryinst	experienced
eksplein	explain
eksploit	exploit
eksploreišin	exploration
eksplor	explore
eksplod	explode
ekspložin	explosion
eksplineišin	explanation
eksplisit	explicit
ekspres	express
eksprešin	expression
ekskywz	excuse
ekskyws	excuse
eksklwd	exclude
eksklwsiv	exclusive
eksklwsivly	exclusively
ekstendid	extended
ekstend	extend
ekstent	extent
ekstensiv	extensive
ekstenšin	extension
ekstørnul	external
ekstrordinery	extraordinary
ekstru	extra
ekstrym	extreme
ekstrymly	extremely
ekstšeindž	exchange
editør	editor
edit	edit
edišin	edition
edžyøkeitør	educator
edžyøkeit	educate
edžyøkeišinul	educational
edžyøkeišin	education
edž	edge
ets.	etc.
ethikul	ethical
ethiks	ethics
ethnik	ethnic
esei	essay
esens	essence
esenšuly	essentially
esenšul	essential
espešuly	especially
eskeip	escape
estäbliš	establish
estäblišmint	establishment
esteit	estate
estimeitid	estimated
estimit	estimate
e-meil	e-mail
oil	oil
o	owe
o	oh
old	old
old-fäšind	old-fashioned
orindž	orange
oridžin	origin
orul	oral
oryinteišin	orientation
or	or
orbit	orbit
orgänik	organic
orginaiz	organize
orginaizd	organized
orginizeišinul	organizational
orginizeišin	organization
orginism	organism
orgin	organ
ordør	order
ordinery	ordinary
onør	owner
onøršip	ownership
on	own
only	only
opining	opening
opin	open
opinly	openly
ovøral	overall
ovørwelming	overwhelming
ovørwelm	overwhelm
ovør	over
ovørløk	overlook
ovørnait	overnight
ovørkum	overcome
ovørsy	oversee
okei	okay
ok	oak
ošin	ocean
ørly	early
ørninks	earnings
ørn	earn
ørbin	urban
ørb	herb
ørdž	urge
ørth	earth
ørthkweik	earthquake
iuw	ie
ilustreit	illustrate
ilygul	illegal
ilwžin	illusion
il	ill
ilnis	illness
imädžineišin	imagination
imädžin	imagine
imošinuly	emotionally
imošinul	emotional
imošin	emotion
imørdžensy	emergency
imørdžing	emerging
imørdž	emerge
imigreišin	immigration
imigrint	immigrant
imidž	image
imišin	emission
imywn	immune
imydyit	immediate
imydyitly	immediately
impasibul	impossible
impäkt	impact
importint	important
importintly	importantly
importins	importance
import	import
impoz	impose
impuls	impulse
implai	imply
implimenteišin	implementation
implimint	implement
implikeišin	implication
impresiv	impressive
impres	impress
imprešin	impression
imprwv	improve
imprwvmint	improvement
imprwvd	improved
inevitibul	inevitable
inevitubly	inevitably
inormus	enormous
inør	inner
inišuly	initially
inišul	initial
inišyeit	initiate
inišyitiv	initiative
inuveitiv	innovative
inuveišin	innovation
inuf	enough
inusint	innocent
in	in
inmeit	inmate
inpøt	input
invait	invite
invalv	involve
invalvmint	involvement
invalvd	involved
inveid	invade
inveižin	invasion
inventory	inventory
invent	invent
invenšin	invention
investør	investor
investigeitør	investigator
investigeit	investigate
investigeišin	investigation
invest	invest
investmint	investment
inviteišin	invitation
invisibul	invisible
infekšin	infection
informul	informal
inform	inform
inførmeišin	information
infint	infant
infleišin	inflation
inflwens	influence
inflwenšul	influential
infrustrukšør	infrastructure
Inggliš	English
inggrydyint	ingredient
inkorpøreit	incorporate
inkum	income
inkwiry	inquiry
inklwding	including
inklwd	include
inkredibul	incredible
inkredibly	incredibly
inkrysing	increasing
inkrysingly	increasingly
inkrys	increase
inkryst	increased
indeks	index
indipendint	independent
indipendins	independence
individžwul	individual
indikeitør	indicator
indikeit	indicate
indikeišin	indication
indidžinis	indigenous
industryul	industrial
industry	industry
Indyin	Indian
indyd	indeed
indžøry	injury
indžør	injure
intäkt	intact
intelidžint	intelligent
intelidžins	intelligence
intend	intend
intent	intent
intensity	intensity
intens	intense
intenšin	intention
integrity	integrity
intøräkt	interact
intøräkšin	interaction
intørupt	interrupt
intørnäšinul	international
intørnet	Internet
intørnul	internal
intørpriteišin	interpretation
intørprit	interpret
intørvenšin	intervention
intørvul	interval
intørvyw	interview
intørfyr	interfere
intilekšwul	intellectual
intimit	intimate
intigreitid	integrated
intigreit	integrate
intigreišin	integration
intyryør	interior
intw	into
intristing	interesting
intristid	interested
intrist	interest
intrudukšin	introduction
intrudws	introduce
insaid	inside
insait	insight
insentiv	incentive
insekt	insect
insørt	insert
insidint	incident
insist	insist
inspair	inspire
inspektør	inspector
inspekšin	inspection
inspireišin	inspiration
instal	install
insted	instead
instinkt	instinct
instint	instant
instintly	instantly
instins	instance
institwšinul	institutional
institwšin	institution
instuleišin	installation
instrumint	instrument
instruktør	instructor
instrukt	instruct
instrukšinul	instructional
instrukšin	instruction
inšørins	insurance
inherint	inherent
inherit	inherit
ifišint	efficient
if	if
ignor	ignore
Itälyin	Italian
it	it
itself	itself
its	its
išyw	issue
uwei	away
uweik	awake
uweit	await
uwer	aware
uwernis	awareness
uword	award
ulaiins	alliance
ulaiv	alive
ulaik	alike
u	a
ularm	alarm
ulang	along
ulangsaid	alongside
uläw	allow
uläbøreit	elaborate
ulevin	eleven
ulekt	elect
ulektranik	electronic
ulektraniks	electronics
ulektrikul	electrical
ulektrik	electric
ulektrisity	electricity
ulekšin	election
uledžid	alleged
uledžidly	allegedly
ulon	alone
ulimineit	eliminate
Ulimpik	Olympic
Ulimpiks	Olympics
u	uh
ulwminum	aluminum
ultimit	ultimate
ultimitly	ultimately
uraivul	arrival
uraiv	arrive
uraiz	arise
uräwnd	around
urei	array
ureindž	arrange
ureindžmint	arrangement
urest	arrest
uridžinuly	originally
uridžinul	original
urynu	arena
umäwnt	amount
umeizing	amazing
Umerikin	American
umendmint	amendment
umid	amid
umung	among
unanimis	anonymous
unäwns	announce
unäwnsmint	announcement
unälisis	analysis
uneibul	unable
unemploimint	unemployment
unekspektid	unexpected
unudhør	another
unyin	onion
unywžwul	unusual
unlaik	unlike
unlaikly	unlikely
unles	unless
unnon	unknown
unpresidentid	unprecedented
unfeir	unfair
unfold	unfold
unfortšinitly	unfortunately
unkul	uncle
unkumftørbul	uncomfortable
unkuvør	uncover
undørlaiing	underlying
undør	under
undørmain	undermine
undørgo	undergo
undørgrädžwit	undergraduate
undørteik	undertake
undørständing	understanding
undørständ	understand
until	until
unsørtin	uncertain
unsørtinty	uncertainty
unhäpy	unhappy
ubäwt	about
ubändin	abandon
ubility	ability
ubuv	above
ubyws	abuse
ubrad	abroad
ubdžektiv	objective
ubdžekt	object
ubdžekšin	objection
ubtein	obtain
ubzorb	absorb
ubzørvør	observer
ubzørv	observe
upalidžaiz	apologize
upalidžy	apology
upart	apart
upartmint	apartment
upan	upon
uperint	apparent
uperintly	apparently
upoint	appoint
upointmint	appointment
uponint	opponent
upoz	oppose
upozd	opposed
upør	upper
upinyin	opinion
upyl	appeal
upyrins	appearance
upyr	appear
uplai	apply
up	up
upraksimitly	approximately
upropryit	appropriate
uprotš	approach
upryšyeit	appreciate
upryšyeišin	appreciation
uprwvul	approval
uprwv	approve
updeit	update
upset	upset
upsterz	upstairs
uveilibility	availability
uveilibul	available
uvoid	avoid
uvin	oven
uv	of
ufeir	affair
ufendør	offender
ufensiv	offensive
ufens	offense
ufekt	affect
uford	afford
ufišuly	officially
ufišul	official
ufreid	afraid
ugen	again
ugenst	against
ugo	ago
ugly	ugly
ugresiv	aggressive
ugrešin	aggression
ugry	agree
ugrymint	agreement
ukamideit	accommodate
ukampliš	accomplish
ukamplišmint	accomplishment
ukäwnting	accounting
ukäwntibility	accountability
ukäwnt	account
ukeižinuly	occasionally
ukeižinul	occasional
ukeižin	occasion
ukording	according
ukør	occur
ukumpiny	accompany
ukyuz	accuse
ukwair	acquire
ukras	across
udapt	adopt
udapšin	adoption
udäpt	adapt
udišinul	additional
udišin	addition
udult	adult
udres	address
udžendu	agenda
udžust	adjust
udžustmint	adjustment
udhørwaiz	otherwise
udhør	other
udhørz	others
utanimy	autonomy
utap	atop
utäk	attack
utätš	attach
utempt	attempt
utendins	attendance
utend	attend
utenšin	attention
utørny	attorney
uträktiv	attractive
uträkt	attract
uträkšin	attraction
utribywt	attribute
utšyv	achieve
utšyvmint	achievement
uthority	authority
usain	assign
usainmint	assignment
usaid	aside
usalt	assault
usembul	assemble
usembly	assembly
uses	assess
usesmint	assessment
usošyeitid	associated
usošyeišin	association
usošyit	associate
usørt	assert
usistint	assistant
usistins	assistance
usist	assist
usumpšin	assumption
uswm	assume
us	us
uslyp	asleep
ustranimør	astronomer
ušwr	assure
uhed	ahead
u'klak	o'clock
yard	yard
yä	yeah
yelo	yellow
yel	yell
yet	yet
yes	yes
yestørdei	yesterday
yor	your
yorz	yours
yorself	yourself
Yørupyin	European
yiyld	yield
yiyr	year
yung	young
yungstør	youngster
yw	you
ywnaitid	united
ywnait	unite
ywnivørsity	university
ywnivørsul	universal
ywnivørs	universe
ywniform	uniform
ywnity	unity
ywnit	unit
ywnyin	union
ywnyk	unique
ywtilaiz	utilize
ywtility	utility
ywth	youth
ywzør	user
ywz	use
ywzd	used
yws	use
ywsful	useful
ywžwuly	usually
ywžwul	usual
yr	ear
yvin	even
yvul	evil
yvning	evening
ygo	ego
ygør	eager
ykosistum	ecosystem
ykwality	equality
ykweižin	equation
ykwuly	equally
ykwul	equal
ydhør	either
yting	eating
yt	eat
ytš	each
yzily	easily
yzy	easy
yz	ease
ystørn	eastern
yst	east
wai	why
wail	while
waildlaif	wildlife
waild	wild
wair	wire
wain	wine
waip	wipe
waif	wife
waidly	widely
waid	wide
waidspred	widespread
wait	white
waiz	wise
wal	wall
wandør	wander
want	want
waking	walking
wak	walk
watør	water
watš	watch
waš	wash
wäw	wow
wägin	wagon
wei	way
wei	weigh
weil	whale
weiv	wave
weik	wake
weidž	wage
weit	wait
weit	weight
weist	waist
weist	waste
wel	well
welfeir	welfare
welkum	welcome
welthy	wealthy
welth	wealth
wel-non	well-known
wel-bying	well-being
weräz	whereas
werevør	wherever
wer	wear
wer	where
werhäws	warehouse
wenevør	whenever
wen	when
Wenzdei	Wednesday
web	web
wepin	weapon
weding	wedding
wedhør	weather
wedhør	whether
wet	wet
westørn	western
west	west
woryør	warrior
wor	war
worm	warm
wormth	warmth
worning	warning
worn	warn
wøwnd	wound
wøry	worry
wøryd	worried
wørldwaid	worldwide
wørld	world
wørkäwt	workout
wørkør	worker
wørking	working
wørk	work
wørkpleis	workplace
wørks	works
wørkšap	workshop
wørd	word
wørth	worth
wømin	woman
wødin	wooden
wød	wood
wød	would
wiling	willing
wilingnis	willingness
wil	will
wildørnis	wilderness
winør	winner
win	win
wing	wing
windo	window
wind	wind
wintør	winter
wip	whip
wido	widow
witnis	witness
witš	which
withäwt	without
within	within
with	with
withdra	withdraw
withdral	withdrawal
wispør	whisper
wisdum	wisdom
wiš	wish
wulf	wolf
wun	one
wundør	wonder
wundørful	wonderful
wuns	once
wun-thørd	one-third
wutevør	whatever
wut	what
wy	we
wyl	wheel
wyltšeir	wheelchair
wyrd	weird
wyv	weave
wykend	weekend
wykin	weaken
wykly	weekly
wyk	weak
wyk	week
wyknis	weakness
wyd	weed
wyt	wheat
laiin	lion
laiibility	liability
lai	lie
lain	line
laibrery	library
laivør	liver
laiv	live
laif	life
laiftaim	lifetime
laifstail	lifestyle
laikwaiz	likewise
laikly	likely
laiklyhød	likelihood
laik	like
laiting	lighting
laitly	lightly
lait	light
laitning	lightning
laisinz	license
la	law
lardžly	largely
lardž	large
lameikør	lawmaker
lan	lawn
lang	long
langtaim	longtime
lang-tørm	long-term
landry	laundry
lantš	launch
laby	lobby
lag	log
lak	lock
ladžikul	logical
ladžik	logic
lat	lot
lats	lots
laswt	lawsuit
las	loss
last	lost
läwd	loud
lämp	lamp
länding	landing
länd	land
ländmark	landmark
ländskeip	landscape
läb	lab
läbritory	laboratory
läp	lap
läf	laugh
läftør	laughter
läk	lack
lädør	ladder
lätør	latter
Lätin	Latin
läst	last
leiør	layer
lei	lay
lein	lane
leinggwidž	language
leibør	labor
leibul	label
leik	lake
leidy	lady
leitør	later
leitly	lately
leit	late
leisør	laser
lemin	lemon
length	length
lend	lend
lenz	lens
levul	level
left	left
legisy	legacy
leg	leg
lekšør	lecture
led	lead
ledžind	legend
ledžisleitør	legislator
ledžisleitiv	legislative
ledžisleitšør	legislature
ledžisleišin	legislation
ledhør	leather
letør	letter
let	let
lesin	lesson
les	less
loyør	lawyer
loyul	loyal
loyulty	loyalty
lowør	lower
lo	low
lonly	lonely
lon	loan
lokeit	locate
lokeišin	location
lokul	local
lod	load
lørning	learning
lørn	learn
løk	look
limiteišin	limitation
limitid	limited
limit	limit
lim	limb
link	link
libørul	liberal
libørty	liberty
lip	lip
living	living
lift	lift
likwid	liquid
lid	lid
lidžitimit	legitimate
litørery	literary
litøruly	literally
litørutšør	literature
litul	little
lisinør	listener
lisin	listen
list	list
lung	lung
luntš	lunch
luvør	lover
luvly	lovely
luv	love
luky	lucky
luk	luck
lyn	lean
lyp	leap
lyv	leave
lyf	leaf
lyguly	legally
lygul	legal
lyg	league
lydør	leader
lydøršip	leadership
lyding	leading
lyd	lead
lyst	least
lwp	loop
lwz	lose
lws	loose
raiit	riot
raivul	rival
raiful	rifle
raidør	rider
raid	ride
raitør	writer
raiting	writing
rait	write
rait	right
raiz	rise
rais	rice
ra	raw
rang	wrong
rakit	rocket
rak	rock
rad	rod
räwnd	round
räwt	route
räly	rally
rändum	random
räntš	ranch
räbit	rabbit
räpidly	rapidly
räpid	rapid
räp	wrap
räk	rack
rädikul	radical
rädhør	rather
rät	rat
räšinul	rational
reil	rail
reilrod	railroad
rein	rain
reink	rank
reindž	range
reip	rape
reidar	radar
reidyeišin	radiation
reidyo	radio
reidž	rage
reiting	rating
reit	rate
reiz	raise
reisizm	racism
reis	race
reišul	racial
reišyo	ratio
relivint	relevant
relitivly	relatively
relitiv	relative
relm	realm
rerly	rarely
rer	rare
rendør	render
rentul	rental
rent	rent
rebul	rebel
repyøteišin	reputation
reprizentitiv	representative
reprizent	represent
reprizinteišin	representation
revenw	revenue
revuleišin	revelation
revulwšinery	revolutionary
revulwšin	revolution
reførens	reference
refywdžy	refugee
refywdž	refuge
regyøleitør	regulator
regyøleit	regulate
regyøleišin	regulation
regyølørly	regularly
regyølør	regular
regyølutory	regulatory
rekørd	record
rekumend	recommend
rekumindeišin	recommendation
rekugnaiz	recognize
rekugnišin	recognition
redily	readily
redy	ready
red	red
redžistør	register
retørik	rhetoric
rezørveišin	reservation
rezilwšin	resolution
rezident	resident
rezidens	residence
rezidenšul	residential
rezumei	resume
resipy	recipe
reskyw	rescue
rest	rest
restrant	restaurant
royul	royal
roling	rolling
rol	role
rol	roll
ro	row
romäntik	romantic
romäns	romance
Romin	Roman
robat	robot
rop	rope
rod	road
roz	rose
rørul	rural
røf	roof
riword	reward
rilaiibility	reliability
rilaiibul	reliable
rilai	rely
riläks	relax
rileitid	related
rileit	relate
rileišin	relation
rileišinšip	relationship
rilidžin	religion
rilidžis	religious
riluktint	reluctant
rily	really
rilyv	relieve
rilyf	relief
rilys	release
rimaindør	reminder
rimaind	remind
rimarkubul	remarkable
rimark	remark
rimeining	remaining
rimein	remain
rimembør	remember
rimot	remote
rimwvul	removal
rimwv	remove
rim	rim
ring	ring
ribin	ribbon
rib	rib
ripeir	repair
riportør	reporter
riporting	reporting
riportidly	reportedly
riport	report
ripublikin	republican
ripublik	republic
ripytidly	repeatedly
ripyt	repeat
riplai	reply
ripleis	replace
ripleismint	replacement
rip	rip
rivør	river
rivørs	reverse
rivyw	review
rivyl	reveal
riform	reform
rifør	refer
rifywz	refuse
riflekt	reflect
riflekšin	reflection
rifridžøreitør	refrigerator
rigarding	regarding
rigardlis	regardless
rigard	regard
rigein	regain
rigret	regret
rikal	recall
rikording	recording
rikord	record
rikuvøry	recovery
rikuvør	recover
rikwair	require
rikwairmint	requirement
rikwaird	required
rikwest	request
rikrwt	recruit
ridikyølis	ridiculous
ridukšin	reduction
ridws	reduce
rid	rid
ridthm	rhythm
ridž	ridge
ritair	retire
ritairmint	retirement
ritaird	retired
ritein	retain
ritørn	return
ritin	written
ritryt	retreat
ritšwul	ritual
ritš	rich
rizain	resign
rizalv	resolve
rizembul	resemble
rizort	resort
rizørv	reserve
rizistins	resistance
rizist	resist
rizult	result
rizwm	resume
risepšin	reception
risešin	recession
risipyint	recipient
risyvør	receiver
risyv	receive
rispandint	respondent
rispand	respond
rispansibility	responsibility
rispansibul	responsible
rispans	response
rispektivly	respectively
rispekt	respect
risky	risky
risk	risk
ristor	restore
rist	wrist
ristrikt	restrict
ristrikšin	restriction
rižym	regime
runør	runner
runing	running
run	run
rubør	rubber
rub	rub
rufly	roughly
ruf	rough
Rušin	Russian
ruš	rush
ryälity	reality
ryäkt	react
ryäkšin	reaction
ryølaiz	realize
ryølistik	realistic
ryinfors	reinforce
ryl	real
ryr	rear
rybild	rebuild
rykal	recall
rydør	reader
ryding	reading
ryd	read
rydžekt	reject
rydžinul	regional
rydžin	region
ryteilør	retailer
ryteil	retail
rytš	reach
ryzinibul	reasonable
ryzin	reason
rysors	resource
rysørtšør	researcher
rysørtš	research
rysintly	recently
rysint	recent
ryhubiliteišin	rehabilitation
rwin	ruin
rwling	ruling
rwl	rule
rwmør	rumor
rwm	room
rwf	roof
rwtynly	routinely
rwtyn	routine
rwt	root
rwt	route
mai	my
maild	mild
mainority	minority
mainør	minor
main	mine
maind	mind
maigreišin	migration
mait	might
maiself	myself
malikywl	molecule
mal	mall
marbul	marble
markør	marker
markiting	marketing
markit	market
markitpleis	marketplace
mark	mark
mardžin	margin
martš	march
mam	mom
manitør	monitor
manyømint	monument
manstør	monster
madørit	moderate
madørn	modern
madifai	modify
madist	modest
madul	model
mäwntin	mountain
mäwnt	mount
mäwth	mouth
mäws	mouse
mänør	manner
mänidžør	manager
mänidžing	managing
mänidž	manage
mänidžmint	management
mänyøfäktšørør	manufacturer
mänyøfäktšøring	manufacturing
mänywul	manual
män	man
mändeit	mandate
mänšin	mansion
mäp	map
mägizyn	magazine
mägnetik	magnetic
mägnitwd	magnitude
mäksimum	maximum
mäd	mad
mädžik	magic
mätør	matter
mätš	match
mäth	math
mäthmätiks	mathematics
mäsiv	massive
mäs	mass
mäsk	mask
mästør	master
meiør	mayor
meil	mail
meil	male
mei	may
meinly	mainly
mein	main
meintein	maintain
meintinins	maintenance
meinstrym	mainstream
meiby	maybe
meikør	maker
meikup	makeup
meik	make
meidžør	major
meit	mate
melt	melt
meridž	marriage
merit	merit
mery	marry
meryd	married
memøry	memory
membør	member
membøršip	membership
menyw	menu
meny	many
mentor	mentor
mentuly	mentally
mentul	mental
menšin	mention
mekinism	mechanism
Meksikin	Mexican
medikeišin	medication
medikul	medical
medisin	medicine
medul	medal
metifor	metaphor
metul	metal
metrupalitin	metropolitan
methid	method
mesidž	message
mes	mess
mežør	measure
mežørmint	measurement
morovør	moreover
morul	moral
mor	more
morning	morning
morgidž	mortgage
mortälity	mortality
momentum	momentum
momint	moment
mobul	mobile
mod	mode
motør	motor
motiveit	motivate
motiveišin	motivation
motiv	motive
mostly	mostly
most	most
mošin	motion
møryn	marine
mørdør	murder
mørtšint	merchant
militery	military
milyin	million
mil	mill
milk	milk
mirør	mirror
minirul	mineral
minimaiz	minimize
minimul	minimal
minimum	minimum
minit	minute
ministør	minister
ministry	ministry
mikänikul	mechanical
mikänik	mechanic
miks	mix
mikst	mixed
mikstšør	mixture
midul	middle
midnait	midnight
midst	midst
mith	myth
mising	missing
misul	missile
mis	miss
misteik	mistake
mistiry	mystery
mistyryis	mysterious
mišinery	missionary
mišin	mission
multipul	multiple
munipyøleit	manipulate
muny	money
munky	monkey
Mundei	Monday
munthly	monthly
munth	month
mud	mud
mudžority	majority
mutør	mutter
mutyriyul	material
mutš	much
muthør	mother
musul	muscle
must	must
mušyn	machine
mušrwm	mushroom
mywnisipul	municipal
mywtšwul	mutual
mywzikul	musical
mywzik	music
mywzišin	musician
mywzyim	museum
myl	meal
my	me
myrikul	miracle
myrly	merely
myr	mere
myning	meaning
myningful	meaningful
mynwail	meanwhile
myn	mean
myntaim	meantime
mynz	means
mydyu	media
mydyum	medium
mytør	meter
myting	meeting
myt	meat
myt	meet
mwn	moon
mwvy	movie
mwv	move
mwvmint	movement
mwd	mood
nain	nine
naif	knife
nait	night
naitmeir	nightmare
nais	nice
nalidž	knowledge
namineišin	nomination
naminy	nominee
nanprafit	nonprofit
navul	novel
nak	knock
nad	nod
nat	not
näw	now
nätšøruly	naturally
nätšørul	natural
nästy	nasty
näšinul	national
neil	nail
neim	name
neibøring	neighboring
neibør	neighbor
neibørhød	neighborhood
neivul	naval
neikid	naked
neitiv	native
neitšør	nature
neišinwaid	nationwide
neišin	nation
nero	narrow
neritiv	narrative
nevør	never
nevør-dhe-les	nevertheless
negitiv	negative
nek	neck
nekst	next
netwørk	network
net	net
nesiserily	necessarily
nesisery	necessary
nest	nest
noiz	noise
nower	nowhere
no	no
no	know
nor	nor
normuly	normally
normul	normal
norm	norm
nordhørn	northern
northyst	northeast
northwest	northwest
north	north
non	known
nobudy	nobody
notis	notice
not	note
notbøk	notebook
noz	nose
nošin	notion
nørvis	nervous
nørv	nerve
nørs	nurse
nigošyeit	negotiate
nigošyeišin	negotiation
nisesity	necessity
numbør	number
nun	none
nun-dhe-les	nonetheless
nut	nut
nuthing	nothing
nyl	kneel
ny	knee
nyrly	nearly
nyr	near
nyrbai	nearby
nydul	needle
nyd	need
nydhør	neither
nyt	neat
nwly	newly
nw	new
nwmøris	numerous
nwn	noon
nwklyr	nuclear
nwtrul	neutral
nwtryint	nutrient
nwz	news
nwzpeipør	newspaper
baialidžy	biology
baiagrify	biography
baiør	buyer
baiis	bias
baiuladžikul	biological
bai	buy
bai	by
baind	bind
Baibul	Bible
baik	bike
bait	bite
baisikul	bicycle
bal	ball
baro	borrow
bar	bar
barn	barn
baming	bombing
bam	bomb
band	bond
baks	box
bady	body
badhør	bother
batul	bottle
batum	bottom
bas	boss
bäw	bow
bäwndry	boundary
bäwns	bounce
bälins	balance
bälinst	balanced
bälit	ballot
bän	ban
bänkør	banker
bänking	banking
bänk	bank
bänkrupsy	bankruptcy
bänd	band
bäg	bag
bäkyard	backyard
bäk	back
bäkgräwnd	background
bäktyryu	bacteria
bädly	badly
bäd	bad
bätøry	battery
bätul	battle
bät	bat
bäth	bath
bäthrwm	bathroom
bäskit	basket
bäskitbal	basketball
bei	bay
beirul	barrel
beiryør	barrier
beiry	bury
beirly	barely
beir	bare
beir	bear
beiby	baby
beik	bake
beisikly	basically
beisik	basic
beisis	basis
beis	base
beismint	basement
beisbal	baseball
bely	belly
bel	bell
belt	belt
benifit	benefit
bend	bend
bentš	bench
beg	beg
bedrwm	bedroom
betør	better
bet	bet
best	best
boil	boil
boi	boy
boifrend	boyfriend
bol	bowl
bold	bold
bolt	bolt
boring	boring
born	born
bordør	border
bord	board
bonis	bonus
bon	bone
bot	boat
both	both
bost	boast
børning	burning
børn	burn
børdin	burden
børd	bird
børth	birth
børthdei	birthday
børst	burst
bøk	book
bøš	bush
bilang	belong
bilo	below
bilyin	billion
bilyv	believe
bilyf	belief
bil	bill
bildør	builder
bilding	building
bild	build
binyth	beneath
bifor	before
bigining	beginning
bigin	begin
big	big
bikum	become
bikuz	because
bid	bed
bid	bid
bitør	bitter
bitwyn	between
bit	bit
bizy	busy
biznis	business
biznismin	businessman
bisaid	beside
bisaidz	besides
bihaind	behind
bihäf	behalf
biheivyorul	behavioral
biheivyør	behavior
biheiv	behave
bulit	bullet
bulwn	balloon
bul	bull
bulb	bulb
bulk	bulk
bunänu	banana
buntš	bunch
bubul	bubble
bug	bug
bukit	bucket
buk	buck
budy	buddy
budžit	budget
butør	butter
butørflai	butterfly
butøn	button
but	but
but	butt
bus	bus
byand	beyond
byøro	bureau
bying	being
bywtiful	beautiful
bywty	beauty
by	bee
by	be
byr	beer
byrd	beard
bym	beam
byn	bean
byf	beef
byt	beat
bytš	beach
byst	beast
bwm	boom
bwt	boot
bwth	booth
bwst	boost
blaind	blind
bland	blond
blak	block
bläk	black
bläst	blast
bleim	blame
bleinkit	blanket
bleink	blank
bleid	blade
blend	blend
blesing	blessing
bles	bless
blo	blow
blink	blink
bludy	bloody
blud	blood
blw	blue
braid	bride
brait	bright
branz	bronze
brad	broad
bradkäst	broadcast
bräwn	brown
bränd	brand
bräntš	branch
brein	brain
breiv	brave
breik	brake
breik	break
brekfist	breakfast
breth	breath
brest	breast
brokør	broker
brokin	broken
brilyint	brilliant
bring	bring
brik	brick
brid	bread
bridž	bridge
Britiš	British
brudhør	brother
bruš	brush
bryfly	briefly
bryf	brief
brydhing	breathing
brydh	breathe
bryz	breeze
brwtul	brutal
paiunyr	pioneer
pailit	pilot
pail	pile
pai	pie
pain	pine
paip	pipe
palitiks	politics
palitišin	politician
palisy	policy
palm	palm
parking	parking
park	park
partikul	particle
partikyølørly	particularly
partikyølør	particular
partisipeit	participate
partisipeišin	participation
partisipent	participant
party	party
partly	partly
part	part
partnør	partner
partnøršip	partnership
paršuly	partially
paršul	partial
pand	pond
papyøleišin	population
papyølerity	popularity
papyølør	popular
pap	pop
pavørty	poverty
pakit	pocket
pat	pot
pazitiv	positive
paz	pause
pasibility	possibility
pasibul	possible
pasibly	possibly
pasta	pasta
päwør	power
päwørful	powerful
päwnd	pound
päwdør	powder
pälis	palace
pänik	panic
pänul	panel
pän	pan
pänts	pants
päkidž	package
päk	pack
päd	pad
pätørn	pattern
pätint	patent
pät	pat
pätš	patch
päth	path
päsing	passing
päsindžør	passenger
päsidž	passage
päs	pass
päst	past
päšin	passion
peil	pale
pei	pay
peir	pair
peimint	payment
pein	pain
peinful	painful
peintør	painter
peinting	painting
peint	paint
peipør	paper
peidž	page
peitrin	patron
peis	pace
peišint	patient
peišins	patience
perint	parent
penulty	penalty
pen	pen
pensul	pencil
penšin	pension
pepør	pepper
pet	pet
pesint	peasant
point	point
poum	poem
powit	poet
powitry	poetry
pol	pole
pol	poll
por	poor
por	pour
pork	pork
port	port
portrei	portray
portrit	portrait
portfolyo	portfolio
portš	porch
poršin	portion
pok	poke
poz	pose
postør	poster
post	post
pøreid	parade
pørentul	parental
pør	per
pørminint	permanent
pørmit	permit
pørmišin	permission
pørpis	purpose
pørpul	purple
pørformør	performer
pørformins	performance
pørform	perform
pørfiktly	perfectly
pørfikt	perfect
pørtšis	purchase
pørsentidž	percentage
pørsepšin	perception
pørsinälity	personality
pørsinel	personnel
pørsinuly	personally
pørsinul	personal
pørsin	person
pørsist	persist
pørsyv	perceive
pørsyvd	perceived
pørsweid	persuade
pørsw	pursue
pørswt	pursuit
pørs	purse
pørspektiv	perspective
Pøržin	Persian
pørhäps	perhaps
pøt	put
pøš	push
pilo	pillow
pil	pill
pin	pin
pink	pink
pig	pig
pikup	pickup
pik	pick
pikšør	picture
pit	pit
pitšør	pitcher
pitš	pitch
pistul	pistol
pulitikul	political
pulitikly	politically
pulys	police
pulysmin	policeman
pulwšin	pollution
pul	pull
puls	pulse
pump	pump
puniš	punish
punišmint	punishment
puntš	punch
publikeišin	publication
publikly	publicly
publik	public
publisity	publicity
publišør	publisher
publiš	publish
puteito	potato
putenšuly	potentially
putenšul	potential
putrol	patrol
puzes	possess
puzešin	possession
puzišin	position
puzul	puzzle
pyäno	piano
pywr	pure
pyl	peel
pyryid	period
pyr	peer
pynut	peanut
pypul	people
pyk	peak
pytsa	pizza
pys	peace
pys	piece
pysful	peaceful
pwl	pool
plat	plot
plänør	planner
pläning	planning
plänit	planet
plän	plan
plänt	plant
plätform	platform
plästik	plastic
pleiaf	playoff
pleiør	player
plei	play
plein	plain
plein	plane
pleintif	plaintiff
pleit	plate
pleis	place
pleismint	placement
plenty	plenty
plezint	pleasant
pležør	pleasure
plundž	plunge
plus	plus
ply	plea
plyd	plead
plyz	please
plyzd	pleased
praiority	priority
praiør	prior
praimerily	primarily
praimery	primary
praim	prime
praivitly	privately
praivit	private
praivisy	privacy
praid	pride
praiz	prize
prais	price
praminint	prominent
pramising	promising
pramis	promise
prampt	prompt
prabubly	probably
prablum	problem
prapørly	properly
prapør	proper
prapørty	property
pravins	province
prafit	profit
pragres	progress
praduktivity	productivity
pradukt	product
pradžekt	project
prasesør	processor
prasesing	processing
prases	process
prasikywtør	prosecutor
prasikywšin	prosecution
praspekt	prospect
präwd	proud
präktikul	practical
präktikly	practically
präktis	practice
präktišinør	practitioner
prei	pray
prei	pray
preir	prayer
preiz	praise
premis	premise
prepøreišin	preparation
prefrins	preference
pregnint	pregnant
pregninsy	pregnancy
preditør	predator
prezinteišin	presentation
prezins	presence
prezidenšul	presidential
prezidint	president
prezidinsy	presidency
pres	press
prešør	pressure
prešis	precious
profail	profile
profäwnd	profound
progräming	programming
progräm	program
prokleim	proclaim
prodws	produce
protest	protest
protikul	protocol
protyn	protein
prohibit	prohibit
priliminery	preliminary
print	print
prinsipul	principal
prinsipul	principle
pripeir	prepare
priveil	prevail
privent	prevent
privenšin	prevention
privlidž	privilege
prifør	prefer
pridikt	predict
pridikšin	prediction
pritend	pretend
prity	pretty
prizent	present
prizent	present
prizørv	preserve
prizinør	prisoner
prizin	prison
prizwmubly	presumably
prisaisly	precisely
prisais	precise
priskripšin	prescription
prumot	promote
prumošin	promotion
pruporšin	proportion
prupozul	proposal
prupoz	propose
prupozd	proposed
pruvaidør	provider
pruvaidid	provided
pruvaid	provide
pruvok	provoke
pruvižin	provision
prufesør	professor
prufešinul	professional
prufešin	profession
prugresiv	progressive
prugres	progress
pruduktiv	productive
prudukšin	production
prudwsør	producer
prudws	produce
prudžekt	project
prudžekšin	projection
prutektiv	protective
prutekt	protect
prutekšin	protection
prusyd	proceed
prusydžør	procedure
prymyum	premium
pryvyisly	previously
pryvyis	previous
prytš	preach
pryst	priest
prwv	prove
prwf	proof
PK	PC
vaiuleit	violate
vaiuleišin	violation
vailint	violent
vailins	violence
vairis	virus
vaitimin	vitamin
vaitul	vital
valintery	voluntary
valintyr	volunteer
valywm	volume
välid	valid
välyibul	valuable
välyw	value
väly	valley
väniš	vanish
vän	van
väkywm	vacuum
väksyn	vaccine
väst	vast
veikeišin	vacation
veryeišin	variation
veryibul	variable
veryis	various
very	vary
very	very
vendør	vendor
ventšør	venture
vedžtibul	vegetable
vetirin	veteran
vesul	vessel
vois	voice
vokul	vocal
votør	voter
voting	voting
vot	vote
vørbul	verbal
vørdikt	verdict
vørtikul	vertical
vørtšwuly	virtually
vørtšwul	virtual
vørtšw	virtue
vørsis	versus
vøržin	version
vilidž	village
viktøry	victory
viktim	victim
vidyo	video
vizibul	visible
vizitør	visitor
vizit	visit
vižin	vision
vižwul	visual
vulidity	validity
vulnøribul	vulnerable
vuraiity	variety
vyikul	vehicle
vyu	via
vywør	viewer
vyw	view
fail	file
fair	fire
fainäns	finance
fainänšul	financial
fainuly	finally
fainul	final
fain	fine
fainding	finding
faind	find
faibør	fiber
faiv	five
faitør	fighter
faiting	fighting
fait	fight
faloing	following
falo	follow
fal	fall
falt	fault
fals	false
far	far
farmør	farmer
farm	farm
fag	fog
fadhør	father
fastør	foster
fäwndeišin	foundation
fäwndør	founder
fäwnd	found
fämily	family
fän	fan
fäntästik	fantastic
fäntusy	fantasy
fäbrik	fabric
fäkulty	faculty
fäktøry	factory
fäktør	factor
fäkt	fact
fät	fat
fäsineiting	fascinating
fästør	faster
fäst	fast
fäšin	fashion
feilyør	failure
feil	fail
feirly	fairly
feir	fair
feir	fare
feimis	famous
feim	fame
feint	faint
feivøribul	favorable
feivør	favor
feivrit	favorite
feid	fade
feitul	fatal
feit	fate
feith	faith
feiz	phase
feis	face
felo	fellow
feminist	feminist
fens	fence
fedørul	federal
fedhør	feather
festivul	festival
fold	fold
forevør	forever
forinør	foreigner
forin	foreign
forist	forest
forum	forum
forwørd	forward
for	four
for	for
formät	format
formeišin	formation
formørly	formerly
formør	former
formul	formal
formyølu	formula
form	form
forget	forget
forgiv	forgive
fork	fork
forty	forty
fortšinitly	fortunately
fortšin	fortune
forth	fourth
forth	forth
fors	force
forhed	forehead
fon	phone
fokis	focus
fok	folk
foto	photo
fotugräf	photograph
før	fur
førmly	firmly
førm	firm
førnitšør	furniture
førbid	forbid
førdhørmor	furthermore
først	first
føt	foot
føtbal	football
filasify	philosophy
filisafikul	philosophical
fil	fill
film	film
filtør	filter
finaminan	phenomenon
finiš	finish
finggør	finger
fifty	fifty
fiftyn	fifteen
fifth	fifth
figyør	figure
fiks	fix
fikst	fixed
fikšin	fiction
fit	fit
fitnis	fitness
fizikul	physical
fizikly	physically
fiziks	physics
fizišin	physician
fiskul	fiscal
fist	fist
fišørmin	fisherman
fišing	fishing
fiš	fish
fuly	fully
ful	full
ful-taim	full-time
fumilyør	familiar
funy	funny
fun	fun
funkšinul	functional
funkšin	function
fundimentul	fundamental
funding	funding
fund	fund
fuking	fucking
futagrifør	photographer
futagrify	photography
futyg	fatigue
fusiliteit	facilitate
fusility	facility
fywør	fewer
fywl	fuel
fyw	few
fywnirul	funeral
fywtšør	future
fyling	feeling
fyl	feel
fy	fee
fyld	field
fyr	fear
fyrs	fierce
fymeil	female
fyvør	fever
fyd	feed
fydbäk	feedback
fytšør	feature
fwl	fool
fwd	food
flaiing	flying
flai	fly
flait	flight
fläwr	flour
fläwr	flower
fläg	flag
flät	flat
fläš	flash
fleim	flame
fleivør	flavor
fleksibility	flexibility
fleksibul	flexible
fleš	flesh
flo	flow
flor	floor
flot	float
flip	flip
flud	flood
fly	flee
flyt	fleet
flwid	fluid
Fraidei	Friday
frad	fraud
fräwn	frown
fräntšaiz	franchise
frägmint	fragment
fräkšin	fraction
frädžul	fragile
freimwørk	framework
freim	frame
freinkly	frankly
freiz	phrase
frendly	friendly
frend	friend
frendšip	friendship
Frentš	French
freš	fresh
frešmin	freshman
frozin	frozen
frum	from
fruntyr	frontier
frunt	front
frustreit	frustrate
frustreišin	frustration
fryly	freely
fry	free
frykwintly	frequently
frykwint	frequent
frykwinsy	frequency
frydum	freedom
fryz	freeze
frwt	fruit
gai	guy
gaidins	guidance
gaidlain	guideline
gaid	guide
galf	golf
garlik	garlic
garbidž	garbage
gardin	garden
gard	guard
Gad	God
gäløry	gallery
gäliksy	galaxy
gäng	gang
gäp	gap
gädhøring	gathering
gädhør	gather
gäsilyn	gasoline
gäs	gas
gei	gay
geim	game
gein	gain
geit	gate
geiz	gaze
gerinty	guarantee
get	get
ges	guess
gest	guest
gol	goal
go	go
goldin	golden
gold	gold
got	goat
gost	ghost
gøraž	garage
gørl	girl
gørlfrend	girlfriend
gød	good
gilty	guilty
gilt	guilt
givin	given
giv	give
giftid	gifted
gift	gift
gitar	guitar
gun	gun
guvørmint	government
guvørn	govern
guvinør	governor
gut	gut
gyr	gear
gläns	glance
gläd	glad
gläs	glass
glory	glory
globul	global
glob	globe
glimps	glimpse
gluv	glove
gräwnd	ground
gränd	grand
grändmudhør	grandmother
grändperint	grandparent
grändfadhør	grandfather
gränt	grant
gräntšaild	grandchild
gräb	grab
grävity	gravity
grädžweit	graduate
grädžweišin	graduation
grädžwily	gradually
grädžwit	graduate
gräs	grass
gräsp	grasp
grei	gray
grein	grain
greip	grape
greiv	grave
greid	grade
greitist	greatest
greitly	greatly
greit	great
greitful	grateful
greis	grace
groing	growing
gro	grow
groth	growth
gros	gross
grošry	grocery
grin	grin
grip	grip
gryn	green
gryf	grief
Gryk	Greek
gryt	greet
grwp	group
kaind	kind
kalør	collar
kaliny	colony
kalidž	college
kalum	column
kalumnist	columnist
kalyg	colleague
kal	call
kalm	calm
kar	car
karbin	carbon
karbuhaidreit	carbohydrate
karpit	carpet
karv	carve
kargo	cargo
kard	card
kartwn	cartoon
kart	cart
kaminly	commonly
kamin	common
kamint	comment
kamudy	comedy
kambät	combat
kambineišin	combination
kampinseišin	compensation
kampitišin	competition
kampuzišin	composition
kamplikeitid	complicated
kamprimaiz	compromise
kamprubul	comparable
kampryhensiv	comprehensive
kanvørseišin	conversation
kanvikt	convict
kanfidint	confident
kanfidins	confidence
kanflikt	conflict
kanfrinteišin	confrontation
kanfrins	conference
Kanggris	Congress
kankryt	concrete
kandukt	conduct
kantäkt	contact
kantekst	context
kantest	contest
kantinint	continent
kantumpleit	contemplate
kanträktør	contractor
kanträkt	contract
kanträst	contrast
kantribywšin	contribution
kantruvørsy	controversy
kantruvøršul	controversial
kansept	concept
kansørveišin	conservation
kansørt	concert
kansintreit	concentrate
kansintreišin	concentration
kansikwently	consequently
kansikwens	consequence
kanstintly	constantly
kanstint	constant
kanstitwt	constitute
kanstitwšinul	constitutional
kanstitwšin	constitution
kanstrukt	construct
kanšins	conscience
kanšis	conscious
kanšisnis	consciousness
kapy	copy
kap	cop
kafy	coffee
kagnitiv	cognitive
katin	cotton
katidž	cottage
kaz	cause
kastwm	costume
kastly	costly
kast	cost
käw	cow
käwntør	counter
käwntørpart	counterpart
käwnty	county
käwnt	count
käwnsulør	counselor
käwnsuling	counseling
käwnsul	counsel
käwnsul	council
käwtš	couch
kälindør	calendar
kälkyøleit	calculate
kälkyøleišin	calculation
kämru	camera
kämpein	campaign
kämpis	campus
kämp	camp
kän	can
känvis	canvas
kändidit	candidate
kändul	candle
kändy	candy
känsør	cancer
känsul	cancel
käbinit	cabinet
käbin	cabin
käb	cab
käpitul	capital
käp	cap
käptin	captain
käpšør	capture
kätigory	category
kätulag	catalog
kätul	cattle
kät	cat
kätš	catch
Käthlik	Catholic
käst	cast
käžulty	casualty
käžwul	casual
käš	cash
keias	chaos
keibul	cable
keipibility	capability
keipibul	capable
keiv	cave
keik	cake
keidž	cage
keis	case
keriktøraiz	characterize
keriktøristik	characteristic
keriktør	character
kerit	carrot
keryør	carrier
kery	carry
ker	care
kerfuly	carefully
kerful	careful
kemikul	chemical
kemistry	chemistry
koapøreit	cooperate
koapøreišin	cooperation
koapøritiv	cooperative
koilišin	coalition
koin	coin
kol	coal
kold	cold
korileišin	correlation
koridor	corridor
korispandint	correspondent
Koryin	Korean
kor	core
kornør	corner
korn	corn
korpøreišin	corporation
korpørit	corporate
kord	cord
kort	court
kortrwm	courtroom
kors	coarse
kors	course
kop	cope
kokein	cocaine
kod	code
kot	coat
kotš	coach
kostul	coastal
kost	coast
køwordineitør	coordinator
køwordineit	coordinate
køwordinits	coordinates
kørektly	correctly
kørekt	correct
kørintly	currently
kørint	current
kørinsy	currency
kørikyølum	curriculum
køridž	courage
kørupšin	corruption
køryr	career
kørv	curve
kørtin	curtain
køking	cooking
køky	cookie
køk	cook
kød	could
kilør	killer
kiling	killing
kil	kill
king	king
kingdum	kingdom
kik	kick
kid	kid
kit	kit
kitšin	kitchen
kis	kiss
kuläbøreišin	collaboration
kuläps	collapse
kulektør	collector
kulektiv	collective
kulekt	collect
kulekšin	collection
kulestøral	cholesterol
kulonyul	colonial
kulør	color
kulørful	colorful
kultšørul	cultural
kultšør	culture
kumadity	commodity
kumändør	commander
kumänd	command
kumøršul	commercial
kuming	coming
kumity	committee
kumit	commit
kumitmint	commitment
kumišinør	commissioner
kumišin	commission
kumywnikeit	communicate
kumywnikeišin	communication
kumywnity	community
kum	come
kumbain	combine
kumbaind	combined
kumpäwnd	compound
kumpänyin	companion
kumpeling	compelling
kumpel	compel
kumperisin	comparison
kumper	compare
kumpetitør	competitor
kumpetitiv	competitive
kumponint	component
kumpoz	compose
kumpiny	company
kumpywtør	computer
kumpyt	compete
kumplaiins	compliance
kumplai	comply
kumplein	complain
kumpleint	complaint
kumpleksity	complexity
kumpleks	complex
kumplytly	completely
kumplyt	complete
kumpraiz	comprise
kumført	comfort
kumftørbul	comfortable
Kuneidyin	Canadian
kunekt	connect
kunekšin	connection
kunvei	convey
kunvenšinul	conventional
kunvenšin	convention
kunvørt	convert
kunvøržin	conversion
kunvins	convince
kunvinst	convinced
kunvikšin	conviction
kunvynyins	convenience
kunfes	confess
kunfešin	confession
kunfirm	confirm
kunfywz	confuse
kunfywžin	confusion
kunflikt	conflict
kunfrunt	confront
kunggrešinul	congressional
kunklwd	conclude
kunklwžin	conclusion
kundem	condemn
kundišin	condition
kundukt	conduct
kunteinør	container
kuntein	contain
kuntempørery	contemporary
kuntend	contend
kuntent	content
kuntinywing	continuing
kuntinywis	continuous
kuntinyw	continue
kuntinywd	continued
kuntrol	control
kuntribyøtør	contributor
kuntribywt	contribute
kuntry	country
kunsent	consent
kunsensis	consensus
kunsepšin	conception
kunsekyøtiv	consecutive
kunsørning	concerning
kunsørn	concern
kunsørnd	concerned
kunsørvitiv	conservative
kunsidøreišin	consideration
kunsidøribul	considerable
kunsidøribly	considerably
kunsidør	consider
kunsistintly	consistently
kunsistint	consistent
kunsist	consist
kunsultint	consultant
kunsult	consult
kunsumpšin	consumption
kunsyv	conceive
kunsyd	concede
kunswmør	consumer
kunswm	consume
kunspirisy	conspiracy
kunstreint	constraint
kunstrukt	construct
kunstrukšin	construction
kupäsity	capacity
kupul	couple
kup	cup
kuvør	cover
kuvridž	coverage
kut	cut
kuzin	cousin
kusyno	casino
kustidy	custody
kustumør	customer
kustum	custom
kyøryasity	curiosity
kyøryis	curious
kyør	cure
kyw	cue
Kywbin	Cuban
kywt	cute
ky	key
kyp	keep
kwaiitly	quietly
kwaiit	quiet
kwait	quite
kwalifai	qualify
kwality	quality
kwantity	quantity
kwest	quest
kwestšineir	questionnaire
kwestšin	question
kwortør	quarter
kwortørbäk	quarterback
kwot	quote
kwikly	quickly
kwik	quick
kwit	quit
kwyn	queen
kwl	cool
kw	coup
klaiint	client
klaimit	climate
klaim	climb
klak	clock
klath	cloth
klazit	closet
kläwd	cloud
kläsifai	classify
kläsikul	classical
kläsik	classic
kläs	class
kläsrwm	classroom
klei	clay
kleim	claim
klodhing	clothing
klodhz	clothes
kloz	close
klozd	closed
klosør	closer
klosist	closest
klosly	closely
klos	close
klørk	clerk
klinikul	clinical
klinik	clinic
kling	cling
klip	clip
klif	cliff
klik	click
klub	club
klustør	cluster
klyrly	clearly
klyr	clear
klyn	clean
klw	clue
krai	cry
kraim	crime
kraityryu	criteria
kraisis	crisis
kral	crawl
kranik	chronic
krap	crop
kras	cross
kräwdid	crowded
kräwd	crowd
kräft	craft
kräk	crack
kräš	crash
kreizy	crazy
kredibility	credibility
kredit	credit
kriminul	criminal
kritikul	critical
kritik	critic
kritisaiz	criticize
kritisizm	criticism
Krismis	Christmas
kristul	crystal
Kristšin	Christian
Kristšyänity	Christianity
kruš	crush
kryeitivity	creativity
kryeitiv	creative
kryeit	create
kryeišin	creation
krym	cream
krytšør	creature
krwl	cruel
krw	crew
krwz	cruise
krwšul	crucial
daiägnosis	diagnosis
daiägnos	diagnose
daiørai	diary
daiing	dying
daiit	diet
daiulag	dialogue
daiubytyz	diabetes
dai	die
daimind	diamond
dainämik	dynamic
dainämiks	dynamics
daining	dining
dal	doll
dark	dark
darknis	darkness
damineit	dominate
daminint	dominant
dan	dawn
dag	dog
dakyømentøry	documentary
dakyømint	document
dak	dock
daktør	doctor
daktrin	doctrine
datør	daughter
dat	dot
däwn	down
däwntäwn	downtown
däwt	doubt
dämidž	damage
däm	dam
däm	damn
dänsør	dancer
dänsing	dancing
däns	dance
däd	dad
deily	daily
dei	day
deir	dare
deindžøris	dangerous
deindžør	danger
deibyw	debut
deitu	data
deitubeis	database
deit	date
delikit	delicate
deminstreit	demonstrate
deminstreišin	demonstration
demigräfik	demographic
demikrätik	democratic
density	density
dens	dense
depyøty	deputy
depth	depth
devisteiting	devastating
devul	devil
definitly	definitely
definišin	definition
defisit	deficit
dekeid	decade
dekøreit	decorate
dek	deck
dedikeit	dedicate
dedlain	deadline
dedly	deadly
det	debt
deth	death
dezørt	desert
despritly	desperately
desprit	desperate
desk	desk
destineišin	destination
do	dough
dorwei	doorway
dor	door
domein	domain
doneit	donate
doneišin	donation
donør	donor
dos	dose
døring	during
dørty	dirty
dørt	dirt
dilait	delight
dilei	delay
dilemu	dilemma
dilibritly	deliberately
dilivøry	delivery
dilivør	deliver
diraiv	derive
direktør	director
direktly	directly
direkt	direct
direkšin	direction
dimakrisy	democracy
dimänd	demand
dimenšin	dimension
diminiš	diminish
dinaiul	denial
dinai	deny
dinør	dinner
dibeit	debate
dipart	depart
dipartmint	department
dipartšør	departure
dipending	depending
dipendint	dependent
dipend	depend
diposit	deposit
dipikt	depict
diploi	deploy
diplimätik	diplomatic
diplimät	diplomat
dip	dip
diprest	depressed
diprešin	depression
divain	divine
divaid	divide
divais	device
divelupør	developer
diveluping	developing
divelup	develop
divelupmentul	developmental
divelupmint	development
divors	divorce
divot	devote
divørsity	diversity
divørs	diverse
divižin	division
difain	define
difendør	defender
difendint	defendant
difend	defend
difensiv	defensive
difens	defense
diførintly	differently
diførint	different
diførins	difference
difør	differ
difikulty	difficulty
difikult	difficult
difyt	defeat
dig	dig
digry	degree
dignity	dignity
diklain	decline
dikler	declare
dikrys	decrease
dikteit	dictate
did	dead
didžitul	digital
ditektiv	detective
ditekt	detect
ditørmineišin	determination
ditørmin	determine
dizair	desire
dizainør	designer
dizain	design
dizalv	dissolve
dizästør	disaster
dizørv	deserve
dizørt	dessert
dizyz	disease
disaid	decide
diseibld	disabled
disend	descend
disordør	disorder
disiplin	discipline
disižin	decision
disubility	disability
disupointid	disappointed
disupointmint	disappointment
disupyr	disappear
disugry	disagree
dismis	dismiss
dispait	despite
dispywt	dispute
displei	display
diskäwnt	discount
diskors	discourse
diskøridž	discourage
diskuvøry	discovery
diskuvør	discover
diskus	discuss
diskušin	discussion
diskloz	disclose
disk	disk
disk	disc
diskraib	describe
diskrimineišin	discrimination
diskripšin	description
distørbing	disturbing
distørb	disturb
distinggwiš	distinguish
distinktiv	distinctive
distinkt	distinct
distinkšin	distinction
distint	distant
distins	distance
disträkt	distract
distroi	destroy
distribywt	distribute
distribywšin	distribution
distrikt	district
distrukšin	destruction
diš	dish
dumestik	domestic
dum	dumb
dump	dump
dubul	double
dubry	debris
duk	duck
Dutš	Dutch
duzin	dozen
dust	dust
dylør	dealer
dyl	deal
dyr	dear
dyr	deer
dym	deem
dyply	deeply
dyp	deep
dykrys	decrease
dyteil	detail
dyteild	detailed
dysint	decent
dw	do
dw	due
dwty	duty
drai	dry
draing	drawing
draivør	driver
draiving	driving
draivwei	driveway
draiv	drive
draid	dried
dra	draw
dramu	drama
drap	drop
dräwn	drown
dräft	draft
dräg	drag
drein	drain
dres	dress
dror	drawer
dril	drill
drinking	drinking
drink	drink
drift	drift
drumätikly	dramatically
drumätik	dramatic
drum	drum
drunk	drunk
drug	drug
drym	dream
džaiint	giant
dža	jaw
džar	jar
džab	job
Džäpinyz	Japanese
džäkit	jacket
džäz	jazz
džeil	jail
dženøreit	generate
dženøreišin	generation
dženøris	generous
dženøruly	generally
dženørul	general
dženywin	genuine
džendør	gender
džentul	gentle
džentulmin	gentleman
džently	gently
džet	jet
džestšør	gesture
džoi	joy
džoin	join
džoint	joint
džok	joke
džørør	juror
džøry	jury
Džørmin	German
džørnulizm	journalism
džørnulist	journalist
džørnul	journal
džørny	journey
džim	gym
džinetik	genetic
džump	jump
džunggul	jungle
džudž	judge
džudžmint	judgment
džustifai	justify
džustis	justice
džust	just
džynyis	genius
džyn	gene
džynz	jeans
džwlry	jewelry
džwrisdikšin	jurisdiction
džwnyør	junior
džwdišul	judicial
džws	juice
dhän	than
dhät	that
dhei	they
dher	their
dher	there
dherbai	thereby
dherfor	therefore
dhem	them
dhemselvz	themselves
dhen	then
dho	though
dhoz	those
dhis	this
dhu	the
dhus	thus
dhyz	these
tail	tile
tai	tie
tair	tire
taird	tired
taiming	timing
taim	time
tainy	tiny
taip	type
taid	tide
taitin	tighten
taitul	title
taitly	tightly
tait	tight
taløreit	tolerate
talørins	tolerance
tal	tall
targit	target
tapik	topic
tap	top
tak	talk
taksik	toxic
tas	toss
täwør	tower
täwl	towel
täwn	town
tälentid	talented
tälint	talent
täp	tap
täg	tag
täkul	tackle
täktik	tactic
täks	tax
täkspeiør	taxpayer
täsk	task
TEA	CEO
teil	tail
teil	tale
teink	tank
teibul	table
teibulspwn	tablespoon
teip	tape
teik	take
teist	taste
televižin	television
telefon	telephone
teleskop	telescope
tel	tell
terørism	terrorism
terørist	terrorist
terør	terror
teribul	terrible
teribly	terribly
teritory	territory
ter	tear
tempørery	temporary
tempul	temple
tempritšør	temperature
tenis	tennis
ten	ten
tendør	tender
tendinsy	tendency
tend	tend
tent	tent
tenšin	tension
teknalidžy	technology
tekniladžikul	technological
teknikul	technical
teknišin	technician
teknyk	technique
tekst	text
tekstbøk	textbook
tekstšør	texture
testimony	testimony
testing	testing
testifai	testify
test	test
toilit	toilet
toi	toy
tol	toll
to	toe
ton	tone
totuly	totally
totul	total
tørein	terrain
tørifik	terrific
tørm	term
tørmz	terms
tørnimint	tournament
tørn	turn
tørky	turkey
til	till
timbør	timber
tipikul	typical
tipikly	typically
tip	tip
tikit	ticket
tišyw	tissue
tumaro	tomorrow
tumato	tomato
tumeito	tomato
tunait	tonight
tunul	tunnel
tung	tongue
tubäko	tobacco
tuf	tough
tugedhør	together
tuk	tuck
tudei	today
tutš	touch
tutšdäwn	touchdown
ty	tea
tym	team
tymmeit	teammate
tyneidžør	teenager
tyneidž	teenage
tyn	teen
tytšør	teacher
tytšing	teaching
tytš	teach
tyspwn	teaspoon
twais	twice
twelv	twelve
twentyith	twentieth
twenty	twenty
tword	toward
twordz	towards
twin	twin
twist	twist
twl	tool
tw	too
tw	to
tw	two
twrism	tourism
twrist	tourist
twr	tour
twmør	tumor
twn	tune
twb	tube
twth	tooth
Twzdei	Tuesday
tw-thørdz	two-thirds
traiul	trial
traiumf	triumph
trai	try
traibul	tribal
traib	tribe
tramu	trauma
trapikul	tropical
tränsäkšin	transaction
tränsit	transit
tränsišin	transition
tränsleit	translate
tränsleišin	translation
tränsmit	transmit
tränsmišin	transmission
tränsport	transport
tränspørteišin	transportation
tränsform	transform
tränsfør	transfer
tränsførmeišin	transformation
träp	trap
trävilør	traveler
trävul	travel
träfik	traffic
träk	track
trädžik	tragic
trädžidy	tragedy
träš	trash
treilør	trailer
treil	trail
trei	tray
treinør	trainer
treining	training
trein	train
treiding	trading
treid	trade
treit	trait
treis	trace
trend	trend
trežør	treasure
trimendis	tremendous
trim	trim
trip	trip
trigør	trigger
trik	trick
trunk	trunk
trubul	trouble
trubuld	troubled
truk	truck
trudišinuly	traditionally
trudišinul	traditional
trudišin	tradition
trust	trust
try	tree
tryty	treaty
tryt	treat
trytmint	treatment
trwly	truly
trw	true
trwp	troop
trwth	truth
TV	TV
tšaild	child
tšaildhød	childhood
Tšainyz	Chinese
tšarm	charm
tšardž	charge
tšartør	charter
tšart	chart
tšap	chop
tšaklit	chocolate
tšälindž	challenge
tšämpyin	champion
tšämpyinšip	championship
tšänul	channel
tšäns	chance
tšäptør	chapter
tšeimbør	chamber
tšein	chain
tšeindžing	changing
tšeindž	change
tšeis	chase
tšerity	charity
tšer	chair
tšermin	chairman
tšek	check
tšest	chest
tšois	choice
tšørtš	church
tšil	chill
tšin	chin
tšip	chip
tšikin	chicken
tšunk	chunk
tšyr	cheer
tšyp	cheap
tšyf	chief
tšyk	cheek
tšyt	cheat
tšyz	cheese
tšw	chew
tšwz	choose
thai	thigh
that	thought
thäwzind	thousand
thänk	thank
thänks	thanks
Thänksgiving	Thanksgiving
theripist	therapist
theripy	therapy
thøro	thorough
thøruly	thoroughly
thørd	third
thørty	thirty
Thørzdei	Thursday
thiry	theory
thin	thin
thing	thing
thinking	thinking
think	think
thik	thick
thum	thumb
thyalidžy	theology
thyiladžikul	theological
thyiretikul	theoretical
thyitør	theater
thym	theme
thraiv	thrive
thred	thread
thretin	threaten
thret	threat
threšhold	threshold
thro	throw
throt	throat
thry	three
thrwäwt	throughout
thrw	through
T-šørt	T-shirt
zon	zone
saiintifik	scientific
saiintist	scientist
saiins	science
sailint	silent
sailins	silence
sai	sigh
saimulteinyøsly	simultaneously
sain	sign
saikalidžist	psychologist
saikalidžy	psychology
saikuladžikul	psychological
saikul	cycle
saidwak	sidewalk
said	side
sait	sight
sait	site
sait	cite
saiz	size
salid	solid
salv	solve
salt	salt
sary	sorry
sang	song
savrinty	sovereignty
safin	soften
saftwer	software
saftly	softly
saft	soft
sakør	soccer
sak	sock
sas	sauce
säwnd	sound
säwthyst	southeast
säwthwest	southwest
säwth	south
säløry	salary
sälid	salad
sämin	salmon
sämpul	sample
sändwitš	sandwich
sänd	sand
säk	sack
säkrifais	sacrifice
säd	sad
Sätørdei	Saturday
sätisfai	satisfy
sätisfäkšin	satisfaction
sätulait	satellite
seil	sail
seil	sale
seilz	sales
sei	say
seim	same
seinkšin	sanction
seiving	saving
seiv	save
seifly	safely
seif	safe
seifty	safety
seik	sake
seikrid	sacred
selør	seller
selubreit	celebrate
selubreišin	celebration
sel	sell
sel	cell
self	self
self-estym	self-esteem
seldum	seldom
serumony	ceremony
seminar	seminar
semitery	cemetery
senitor	senator
Senit	Senate
send	send
sentør	center
sentimint	sentiment
sentins	sentence
sent	scent
sentrul	central
sentšøry	century
senseišin	sensation
sensør	sensor
sensitivity	sensitivity
sensitiv	sensitive
sens	sense
sepøreišin	separation
sepireit	separate
sepirit	separate
sevørul	several
sevin	seven
sevinth	seventh
sevyr	severe
segmint	segment
sekind	second
sekundery	secondary
sekyølør	secular
sekyørity	security
sekyør	secure
sekritery	secretary
sektør	sector
sekšin	section
seting	setting
setul	settle
setulmint	settlement
set	set
sešin	session
soil	soil
solør	solar
solly	solely
sol	soul
sol	sole
soldžør	soldier
so	so
sor	soar
sord	sword
sort	sort
sors	source
sop	soap
Sovyit	Soviet
sofu	sofa
sok	soak
sodyim	sodium
sošuly	socially
sošul	social
so-kald	so-called
søräwnding	surrounding
søräwnd	surround
sør	sir
sørvaivør	survivor
sørvaivul	survival
sørvaiv	survive
sørveilins	surveillance
sørvei	survey
sørving	serving
sørvint	servant
sørvis	service
sørv	serve
sørfis	surface
sørkit	circuit
sørkul	circle
sørkumstäns	circumstance
sørdžøry	surgery
sørdžin	surgeon
sørtinly	certainly
sørtin	certain
sørtš	search
silebrity	celebrity
silekt	select
silekšin	selection
sily	silly
silvør	silver
silk	silk
siryisly	seriously
siryis	serious
siryz	series
similerity	similarity
similørly	similarly
similør	similar
simbalik	symbolic
simbul	symbol
simpithy	sympathy
simpul	simple
simply	simply
simptum	symptom
sineryo	scenario
sin	sin
singør	singer
sing	sing
singgul	single
sink	sink
sindrom	syndrome
sins	since
sibling	sibling
sivilizeišin	civilization
sivilyin	civilian
sivik	civic
sivul	civil
sivyrly	severely
sigøret	cigarette
signifikintly	significantly
signifikint	significant
signifikins	significance
signitšør	signature
signul	signal
sik	sick
siks	six
siksth	sixth
sitizin	citizen
sitizinšip	citizenship
sity	city
sit	sit
sitšweišin	situation
sistør	sister
sistum	system
sulektid	selected
sulwšin	solution
sumøry	summary
sumør	summer
sumit	summit
sumwer	somewhere
sumwun	someone
sumwut	somewhat
sum	some
sum	sum
sumbudy	somebody
sumdei	someday
sumtaim	sometime
sumtaimz	sometimes
sumthing	something
sumhäw	somehow
suny	sunny
sunlait	sunlight
sun	son
sun	sun
Sundei	Sunday
subørbin	suburban
subørb	suburb
submit	submit
subdžekt	subject
subsikwint	subsequent
subsidy	subsidy
substänšuly	substantially
substänšul	substantial
substins	substance
suportør	supporter
suportiv	supportive
suport	support
supozidly	supposedly
supoz	suppose
supozd	supposed
suplaiør	supplier
suplai	supply
supraizingly	surprisingly
supraizing	surprising
supraiz	surprise
supraizd	surprised
suføring	suffering
sufør	suffer
sufistikeitid	sophisticated
sufišint	sufficient
sugdžest	suggest
sugdžestšin	suggestion
suk	suck
sukses	success
suksesfuly	successfully
suksesful	successful
suksyd	succeed
sudinly	suddenly
sudin	sudden
sudhørn	southern
sutul	subtle
sutš	such
susaiity	society
suspend	suspend
suspekt	suspect
suspišin	suspicion
suspišis	suspicious
susteinibul	sustainable
sustein	sustain
syling	ceiling
syl	seal
sy	sea
sy	see
symingly	seemingly
sym	seem
synyør	senior
syn	scene
sykwins	sequence
syk	seek
sykrit	secret
syd	seed
syt	seat
syzin	season
syz	seize
sys	cease
swalo	swallow
swel	swell
swer	swear
swetør	sweater
swet	sweat
swiming	swimming
swim	swim
swing	swing
switš	switch
swisaid	suicide
swyp	sweep
swyt	suite
swyt	sweet
sw	sue
swn	soon
swpør	super
swpørmarkit	supermarket
swpørvaizør	supervisor
swpyryør	superior
swp	soup
swprym	supreme
swtibul	suitable
swt	suit
slaid	slide
slaitly	slightly
slait	slight
slais	slice
slat	slot
släm	slam
släp	slap
sleivøry	slavery
sleiv	slave
sloly	slowly
slo	slow
slop	slope
slip	slip
slyp	sleep
slyv	sleeve
smail	smile
smal	small
smart	smart
smel	smell
smok	smoke
smwdh	smooth
snäp	snap
sneik	snake
sno	snow
snyk	sneak
spai	spy
spain	spine
spait	spite
spark	spark
spansør	sponsor
spat	spot
späws	spouse
Späniš	Spanish
speir	spare
speis	space
spel	spell
spending	spending
spend	spend
spekyøleit	speculate
spekyøleišin	speculation
spektäkyølør	spectacular
spektrum	spectrum
spesifai	specify
spesifikly	specifically
spesifik	specific
spešulaiz	specialize
spešulist	specialist
spešul	special
spešulty	specialty
sport	sport
spoksmin	spokesman
spil	spill
spirit	spirit
spiritšwul	spiritual
spin	spin
spit	spit
spykør	speaker
spyk	speak
spyd	speed
spytš	speech
spyšyz	species
spwn	spoon
split	split
sprei	spray
spred	spread
spring	spring
sprinkul	sprinkle
sfyr	sphere
skai	sky
skalør	scholar
skaløršip	scholarship
skän	scan
skändul	scandal
skätør	scatter
skeil	scale
skeird	scared
skery	scary
sker	scare
skedžul	schedule
skor	score
skop	scope
skørt	skirt
skil	skill
skild	skilled
skin	skin
skip	skip
skul	skull
skulptšør	sculpture
sky	ski
skym	scheme
skwad	squad
skwer	square
skwyz	squeeze
skwl	school
skrämbul	scramble
skrätš	scratch
skript	script
skrym	scream
skryning	screening
skryn	screen
skrw	screw
stail	style
star	star
startør	starter
starting	starting
start	start
stap	stop
stak	stock
ständørd	standard
ständing	standing
ständ	stand
stäns	stance
stäf	staff
stäk	stack
städyum	stadium
stätis	status
stätšyw	statue
stätšywt	statute
stei	stay
steir	stare
steibul	stable
steik	stake
steik	steak
steidž	stage
steit	state
steitmint	statement
steišin	station
steryotaip	stereotype
ster	stair
stem	stem
step	step
stedily	steadily
stedy	steady
storidž	storage
story	story
stor	store
storm	storm
ston	stone
stov	stove
stør	stir
stil	still
stimyøleit	stimulate
stimyølis	stimulus
stif	stiff
stik	stick
stumik	stomach
stumbul	stumble
stubility	stability
stuf	stuff
study	study
stutistikul	statistical
stutistiks	statistics
styl	steal
styl	steel
styr	steer
stym	steam
styp	steep
stwpid	stupid
stwdint	student
stwdyo	studio
straiking	striking
straik	strike
stra	straw
strangly	strongly
strang	strong
strätidžy	strategy
strein	strain
streindžør	stranger
streindž	strange
streitin	straighten
streit	straight
strengthin	strengthen
strength	strength
stretš	stretch
stres	stress
strok	stroke
string	string
strip	strip
striktly	strictly
strikt	strict
strugul	struggle
strukšørul	structural
strukšør	structure
strutydžik	strategic
strym	stream
stryk	streak
stryt	street
žanru	genre
šai	shy
šain	shine
šarply	sharply
šarp	sharp
šark	shark
šaping	shopping
šap	shop
šak	shock
šat	shot
šäwør	shower
šäwt	shout
šälo	shallow
šäl	shall
šädo	shadow
šeim	shame
šeip	shape
šeik	shake
šeid	shade
šel	shell
šelf	shelf
šeltør	shelter
šer	share
šerd	shared
šerholdør	shareholder
šef	chef
šed	shed
šoldør	shoulder
šo	show
šor	shore
šortidž	shortage
šortly	shortly
šort	short
šorts	shorts
šort-tørm	short-term
šørly	surely
šør	sure
šørt	shirt
šøgør	sugar
šød	should
šip	ship
šift	shift
šit	shit
šuv	shove
šutul	shuttle
šut	shut
šy	she
šyr	sheer
šyp	sheep
šyt	sheet
šw	shoe
šwting	shooting
šwt	shoot
šrimp	shrimp
šrink	shrink
šrug	shrug
haiwei	highway
hailait	highlight
haily	highly
hai	hi
hai	high
hair	hire
haipathisis	hypothesis
haik	hike
haid	hide
hait	height
hai-tek	high-tech
halidei	holiday
halwei	hallway
hal	haul
hal	hall
ha	ha
harmuny	harmony
harm	harm
harvist	harvest
hardwer	hardware
hardly	hardly
hard	hard
hart	heart
harš	harsh
haky	hockey
hat	hot
haspitul	hospital
hastidž	hostage
hastul	hostile
häwevør	however
häw	how
häwzing	housing
häws	house
häwšold	household
häng	hang
händul	handle
händ	hand
händful	handful
hänsum	handsome
häbität	habitat
häbit	habit
häpily	happily
häpin	happen
häpy	happy
häpynis	happiness
häv	have
häfwei	halfway
häf	half
hät	hat
häzørd	hazard
hei	hey
heir	hair
heit	hate
helo	hello
helikaptør	helicopter
hel	hell
helmit	helmet
help	help
helpful	helpful
helthy	healthy
helth	health
heritidž	heritage
hens	hence
hevily	heavily
hevin	heaven
hevy	heavy
hedeik	headache
hedlain	headline
hed	head
hedkwortørz	headquarters
heziteit	hesitate
holy	holy
hol	whole
hol	hole
hold	hold
horør	horror
horibul	horrible
hormon	hormone
horn	horn
hors	horse
homwørk	homework
homländ	homeland
homlis	homeless
hom	home
hop	hope
hopfuly	hopefully
hotel	hotel
host	host
høraizin	horizon
høräsmint	harassment
hørikein	hurricane
høry	hurry
hør	her
hørt	hurt
hørz	hers
hørself	herself
høk	hook
hil	hill
him	him
himself	himself
hint	hint
hip	hip
hidin	hidden
hit	hit
hiz	his
Hispänik	Hispanic
historikul	historical
historikly	historically
historik	historic
historyin	historian
histøry	history
hu	huh
huny	honey
hunggør	hunger
hunggry	hungry
hundrid	hundred
huntør	hunter
hunting	hunting
hunt	hunt
hug	hug
huzbind	husband
hywmänity	humanity
hywmør	humor
hywmin	human
hywdž	huge
hyl	heal
hyl	heel
hy	he
hyro	hero
hyring	hearing
hyr	hear
hyr	here
hyt	heat
hwevør	whoever
hw	who
hwm	whom
hwz	whose